Component,Number Affirmed on Appeal,Number Partially Affirmed & Partially Reserved/Remanded on Appeal,Number Completely Reserved/Remanded on Appeal,Number of Appeals Closed for Other Reasons,Total,
CBP,116,111,80,36,343,
FLETC,1,0,0,0,1,
ICE,130,13,54,33,230,
OGC,51,12,49,52,164,
OIG,7,4,1,2,14,
TSA,26,6,9,5,46,
USCG,9,0,24,8,41,
USCIS,253,479,217,100,1049,
USSS,25,13,6,1,45,
Total,618,638,440,237,1933,
