Component,Number Affirmed on Appeal,Number Partially Affirmed & Partially Reserved/Remanded on Appeal,Number Completely Reserved/Remanded on Appeal,Number of Appeals Closed for Other Reasons,Total,
FAA,21,17,45,0,83,
FHWA,1,3,1,11,16,
FMCSA,1,0,0,3,4,
FRA,4,0,0,0,4,
FTA,0,0,1,0,1,
MARAD,2,2,0,0,4,
NHTSA,5,1,3,0,9,
OIG,0,2,0,3,5,
OST,3,1,0,0,4,
PHMSA,0,0,0,0,0,
RITA,0,0,0,0,0,
SLSDC,0,0,0,0,0,
Total,37,26,50,17,130,
