Component,Number Affirmed on Appeal,Number Partially Affirmed & Partially Reserved/Remanded on Appeal,Number Completely Reserved/Remanded on Appeal,Number of Appeals Closed for Other Reasons,Total,
BEP,2,0,0,0,2,
BPD,2,0,0,0,2,
DO,15,1,2,2,20,
FinCEN,2,1,0,0,3,
FMS,4,0,0,0,4,
IRS,287,1,0,0,288,
MINT,1,0,1,1,3,
OCC,2,26,11,7,46,
OTS,1,6,1,0,8,
TIGTA,6,10,1,1,18,
TTB,4,2,0,0,6,
Total,326,47,16,11,400,
