Year,Agency,Component,Number Affirmed on Appeal,Number Partially Affirmed & Partially Reserved/Remanded on Appeal,Number Completely Reserved/Remanded on Appeal,Number of Appeals Closed for Other Reasons,Total
2008,CEQ,CEQ,3,0,0,0,3
2008,CFTC,CFTC,4,0,0,0,4
2008,CO,CO,1,0,0,0,1
2008,CPPBSD,CPPBSD,1,0,0,0,1
2008,CSB,CSB,0,0,0,0,0
2008,DHS,CBP,62,55,15,77,209
2008,DHS,FLETC,4,0,0,0,4
2008,DHS,OGC,34,1,10,30,75
2008,DHS,TSA,24,3,6,1,34
2008,DHS,USCG,9,0,5,8,22
2008,DHS,USCIS,155,191,375,1425,2146
2008,DHS,USSS,44,21,6,29,100
2008,DNFSB,OGC,0,0,0,0,0
2008,DNFSB,OGM,0,0,0,0,0
2008,DOC,PTO,15,0,0,2,17
2008,DOC,AGC/Admin.,8,7,5,26,46
2008,DoD,AF,20,32,0,44,96
2008,DoD,ARMY,49,41,13,53,156
2008,DoD,ASBCA,0,0,0,0,0
2008,DoD,CENTCOM,0,0,0,0,0
2008,DoD,DCAA,0,0,0,0,0
2008,DoD,DCMA,0,0,0,0,0
2008,DoD,DeCA,0,0,0,0,0
2008,DoD,DFAS,1,0,0,1,2
2008,DoD,DIA,14,0,0,6,20
2008,DoD,DISA,1,1,0,0,2
2008,DoD,DLA,6,2,1,7,16
2008,DoD,DoDEA,0,0,0,0,0
2008,DoD,DoDIG,5,6,0,2,13
2008,DoD,DSS,0,0,0,0,0
2008,DoD,DTIC,0,0,0,0,0
2008,DoD,DTRA,0,1,0,1,2
2008,DoD,EUCOM,0,0,0,0,0
2008,DoD,JFCOM,0,0,0,0,0
2008,DoD,NAVY,126,26,7,196,355
2008,DoD,NGA,3,0,0,0,3
2008,DoD,NORTHCOM,0,0,0,0,0
2008,DoD,NRO,2,0,0,0,2
2008,DoD,NSA,13,1,0,36,50
2008,DoD,OSD/JS,5,28,16,96,145
2008,DoD,PACOM,0,0,0,0,0
2008,DoD,SOCOM,0,0,0,0,0
2008,DoD,SOUTHCOM,0,0,0,0,0
2008,DoD,STRATCOM,0,0,0,0,0
2008,DoD,TRANSCOM,0,0,0,0,0
2008,DoD,TRICARE,0,0,0,0,0
2008,DOE,HQ,23,7,7,14,51
2008,DOI,Appeals,26,1,61,212,300
2008,DOJ,OIP,1466,0,577,1617,3660
2008,DOJ,USPC,2,3,0,2,7
2008,DOT,FAA,22,5,2,51,80
2008,DOT,FHWA,1,3,0,4,8
2008,DOT,FMCSA,3,2,3,1,9
2008,DOT,FRA,1,1,0,0,2
2008,DOT,FTA,1,0,0,2,3
2008,DOT,MARAD,4,1,0,0,5
2008,DOT,NHTSA,5,2,0,0,7
2008,DOT,OIG,3,4,0,0,7
2008,DOT,OST,3,1,1,1,6
2008,DOT,PHMSA,0,0,1,1,2
2008,DOT,RITA,0,0,0,0,0
2008,DOT,SLSDC,0,1,0,0,1
2008,ED,OM-RIMS,6,16,13,19,54
2008,EPA,HQ,12,37,49,67,165
2008,Ex-Im Bank,Ex-Im Bank,0,0,0,1,1
2008,FCA,FCA,0,0,0,0,0
2008,FCC,FCC,12,0,1,7,20
2008,FCSIC,FCSIC,0,0,0,0,0
2008,FDIC,FDIC,0,0,0,1,1
2008,FEC,FEC,0,0,0,0,0
2008,FERC,FERC,3,0,0,4,7
2008,FFIEC,FFIEC,0,0,0,0,0
2008,FLRA,FSIP,0,0,0,0,0
2008,FLRA,Authority,1,0,0,1,2
2008,FLRA,OGC,1,0,0,2,3
2008,FMCS,FMCS,0,0,0,0,0
2008,FMSHRC,FMSHRC,0,0,0,0,0
2008,FOMC,FOMC,0,0,0,0,0
2008,FRB,FRB,9,0,1,1,11
2008,FTC,FTC,11,2,1,1,15
2008,GSA,GSA,2,4,7,5,18
2008,HHS,CMS,0,1,3,269,273
2008,HHS,OS,22,4,8,63,97
2008,HUD,Agency,24,5,7,5,41
2008,IAF,IAF,0,0,0,0,0
2008,IMLS,IMLS,0,0,0,0,0
2008,MSPB,MSPB,10,0,0,0,10
2008,NARA,NARA,11,1,4,5,21
2008,NASA,OGC,6,2,3,2,13
2008,NCUA,NCUA,2,0,0,1,3
2008,NEH,NEH,1,1,0,0,2
2008,NIGC,NIGC,0,2,0,1,3
2008,NMB,NMB,1,0,0,0,1
2008,NRPC,NRPC,0,0,0,1,1
2008,NSF,Foundation,8,2,0,0,10
2008,NSF,OIG,0,0,0,0,0
2008,OGE,OGE,0,0,0,0,0
2008,OMB,OMB,1,5,0,1,7
2008,ONDCP,OLC,1,0,0,0,1
2008,OPIC,OPIC,1,1,0,0,2
2008,OPM,OPM,25,4,3,0,32
2008,OSHRC,OSHRC,0,0,0,0,0
2008,OSTP,OSTP,0,0,0,0,0
2008,PC,FOIA Office,1,0,0,0,1
2008,PC,OIG,0,0,0,0,0
2008,PRC,PRC,0,0,0,0,0
2008,SBA,SBA,10,2,6,4,22
2008,SEC,HQ,92,10,72,13,187
2008,SSA,SSA,48,11,15,0,74
2008,SSS,SSS,0,0,0,0,0
2008,State,DoS,197,248,25,16,486
2008,STB,STB,0,0,0,0,0
2008,Treasury,BEP,0,1,0,0,1
2008,Treasury,BPD,0,0,0,0,0
2008,Treasury,DO,7,1,0,8,16
2008,Treasury,FinCEN,6,4,0,1,11
2008,Treasury,FMS,6,0,1,0,7
2008,Treasury,IRS,214,1,2,30,247
2008,Treasury,MINT,1,0,0,0,1
2008,Treasury,OCC,8,3,2,0,13
2008,Treasury,OTS,1,0,0,0,1
2008,Treasury,TIGTA,12,5,0,2,19
2008,Treasury,TTB,1,0,0,0,1
2008,TVA,TVA,7,1,0,0,8
2008,U.S. CPSC,U.S. CPSC,21,0,0,3,24
2008,U.S. DOL,DOL,71,84,12,216,383
2008,US RRB,OIG,0,0,0,0,0
2008,US RRB,RRB,1,0,1,0,2
2008,USAID,USAID,2,1,1,0,4
2008,USIBWC,USIBWC,0,0,0,0,0
2008,USITC,USITC,0,0,0,0,0
2008,USNRC,USNRC,5,2,0,2,9
2008,VA,GC (02),81,44,21,84,230
2009,CEQ,CEQ,0,0,0,0,0
2009,CFTC,CFTC,2,1,2,0,5
2009,CIA,CIA,170,17,4,21,212
2009,CO,CO,0,0,0,0,0
2009,CPPBSD,CPPBSD,0,0,1,0,1
2009,CSB,CSB,2,1,0,0,3
2009,DHS,CBP,84,90,32,65,271
2009,DHS,FLETC,2,0,0,0,2
2009,DHS,OGC,8,1,13,51,73
2009,DHS,TSA,23,3,10,1,37
2009,DHS,USCG,22,0,5,11,38
2009,DHS,USCIS,69,470,442,204,1185
2009,DHS,USSS,23,15,14,15,67
2009,DNFSB,OGC,0,0,0,0,0
2009,DNFSB,OGM,0,0,0,0,0
2009,DOC,PTO,14,1,0,0,15
2009,DOC,AGC/Admin.,10,29,27,29,95
2009,DoD,AF,26,30,18,110,184
2009,DoD,AFRICOM,0,0,0,0,0
2009,DoD,ARMY,96,20,21,58,195
2009,DoD,ASBCA,0,0,0,0,0
2009,DoD,CENTCOM,0,0,0,0,0
2009,DoD,DCAA,3,0,0,2,5
2009,DoD,DCMA,1,1,0,1,3
2009,DoD,DeCA,2,0,0,0,2
2009,DoD,DFAS,1,1,0,0,2
2009,DoD,DIA,0,0,0,14,14
2009,DoD,DISA,1,0,0,0,1
2009,DoD,DLA,1,5,2,6,14
2009,DoD,DoDEA,0,0,0,0,0
2009,DoD,DoDIG,6,1,1,2,10
2009,DoD,DSS,0,0,0,2,2
2009,DoD,DTIC,0,0,0,0,0
2009,DoD,DTRA,1,0,0,2,3
2009,DoD,EUCOM,0,0,0,0,0
2009,DoD,JFCOM,0,0,0,0,0
2009,DoD,NAVY,38,39,101,129,307
2009,DoD,NGA,0,0,0,0,0
2009,DoD,NGB,0,0,0,0,0
2009,DoD,NORTHCOM,0,0,0,0,0
2009,DoD,NRO,2,0,0,0,2
2009,DoD,NSA,35,5,3,16,59
2009,DoD,OSD/JS,11,48,22,141,222
2009,DoD,PACOM,0,0,0,0,0
2009,DoD,SOCOM,0,0,0,0,0
2009,DoD,SOUTHCOM,0,0,0,0,0
2009,DoD,STRATCOM,0,0,0,0,0
2009,DoD,TRANSCOM,0,0,0,0,0
2009,DoD,TRICARE,0,0,0,0,0
2009,DOE,HQ,28,9,5,16,58
2009,DOI,Appeals,16,5,30,208,259
2009,DOJ,OIP,1716,150,336,739,2941
2009,DOJ,USPC,5,5,2,0,12
2009,DOT,FAA,50,14,11,35,110
2009,DOT,FHWA,10,5,0,5,20
2009,DOT,FMCSA,0,3,3,2,8
2009,DOT,FRA,4,0,0,0,4
2009,DOT,FTA,1,1,0,0,2
2009,DOT,MARAD,0,1,1,1,3
2009,DOT,NHTSA,4,3,1,0,8
2009,DOT,OIG,0,6,1,3,10
2009,DOT,OST,0,0,0,1,1
2009,DOT,PHMSA,1,1,0,1,3
2009,DOT,RITA,1,1,0,1,3
2009,DOT,SLSDC,0,0,0,0,0
2009,ED,OM-RIMS,0,2,10,43,55
2009,EPA,HQ,59,48,19,91,217
2009,Ex-Im Bank,AGENCY,2,0,0,0,2
2009,FCA,FCA,2,0,0,0,2
2009,FCC,FCC,16,5,8,8,37
2009,FCSIC,FCSIC,0,0,0,0,0
2009,FDIC,FDIC,7,34,4,4,49
2009,FEC,FEC,0,1,0,0,1
2009,FERC,FERC,9,1,1,2,13
2009,FFIEC,FFIEC,0,0,0,0,0
2009,FHFA,FHFA,9,1,0,0,10
2009,FLRA,FSIP,0,0,0,0,0
2009,FLRA,Authority,1,1,0,0,2
2009,FLRA,OGC,0,0,0,0,0
2009,FMCS,FMCS,0,0,0,0,0
2009,FMSHRC,FMSHRC,0,0,0,0,0
2009,FOMC,FOMC,0,0,0,0,0
2009,FRB,FRB,13,4,0,4,21
2009,FTC,FTC,11,3,0,0,14
2009,GSA,GSA,14,2,0,0,16
2009,HHS,CMS,0,1,0,3,4
2009,HHS,OS,51,4,5,110,170
2009,HUD,Agency,20,8,11,0,39
2009,IAF,IAF,0,0,0,0,0
2009,IMLS,IMLS,0,0,0,0,0
2009,MSPB,MSPB,5,0,0,0,5
2009,NARA,NARA,49,5,7,5,66
2009,NASA,OGC,6,2,3,2,13
2009,NCUA,NCUA,8,2,0,0,10
2009,NEH,NEH,1,1,1,0,3
2009,NIGC,NIGC,1,2,0,0,3
2009,NMB,NMB,0,0,0,0,0
2009,NRPC,NRPC,0,0,0,0,0
2009,NSF,Foundation,2,1,0,0,3
2009,NSF,OIG,3,1,0,0,4
2009,OGE,OGE,0,0,0,0,0
2009,OMB,OMB,1,8,0,0,9
2009,ONDCP,OLC,0,0,0,0,0
2009,OPIC,OPIC,2,0,0,0,2
2009,OPM,OPM,22,3,5,1,31
2009,OSHRC,OSHRC,0,0,0,0,0
2009,OSTP,OSTP,1,1,1,0,3
2009,PC,FOIA Office,8,0,0,1,9
2009,PC,OIG,1,0,0,0,1
2009,PRC,PRC,0,0,0,0,0
2009,SBA,SBA,10,9,20,0,39
2009,SEC,HQ,156,13,83,15,267
2009,SIGIR,SIGIR,1,0,1,0,2
2009,SSA,SSA,27,12,66,0,105
2009,SSS,SSS,0,0,0,0,0
2009,State,DoS,88,124,10,26,248
2009,STB,STB,0,0,1,0,1
2009,Treasury,BEP,1,5,1,1,8
2009,Treasury,BPD,2,1,0,0,3
2009,Treasury,DO,16,0,4,0,20
2009,Treasury,FinCEN,4,0,0,0,4
2009,Treasury,FMS,5,2,1,0,8
2009,Treasury,IRS,220,1,0,2,223
2009,Treasury,MINT,2,0,0,1,3
2009,Treasury,OCC,2,2,2,6,12
2009,Treasury,OTS,3,5,0,0,8
2009,Treasury,TIGTA,10,12,1,0,23
2009,Treasury,TTB,5,4,0,0,9
2009,TVA,TVA,8,4,2,0,14
2009,U.S. CPSC,U.S. CPSC,15,0,0,4,19
2009,U.S. DOL,DOL,35,92,17,225,369
2009,US RRB,OIG,0,0,0,0,0
2009,US RRB,RRB,3,0,0,0,3
2009,USAID,USAID,2,1,1,5,9
2009,USITC,USITC,1,0,0,0,1
2009,USNRC,USNRC,6,5,5,4,20
2009,VA,GC,21,15,5,46,87
2010,ABMC,ABMC,0,0,0,0,0
2010,ACUS,ACUS,0,0,0,0,0
2010,BBG,BBG,2,0,0,0,2
2010,CEQ,CEQ,1,0,0,0,1
2010,CFTC,CFTC,3,1,1,2,7
2010,CIA,CIA,110,20,3,48,181
2010,CIGIE,CIGIE,0,0,0,0,0
2010,CNCS,CNCS,2,3,0,0,5
2010,CO,CO,0,0,0,0,0
2010,CPPBSD,CPPBSD,0,0,0,0,0
2010,CSB,CSB,0,0,0,0,0
2010,CSOSA,HQ,0,0,0,0,0
2010,DHS,CBP,188,249,286,92,815
2010,DHS,FLETC,1,0,0,0,1
2010,DHS,ICE,160,107,15,49,331
2010,DHS,OGC,41,6,15,72,134
2010,DHS,TSA,5,1,2,6,14
2010,DHS,USCG,15,0,44,3,62
2010,DHS,USCIS,441,2792,498,193,3924
2010,DHS,USSS,16,10,7,11,44
2010,DNFSB,OGC,0,0,0,1,1
2010,DNFSB,OGM,0,0,0,0,0
2010,DOC,PTO,3,3,0,5,11
2010,DOC,AGC/Admin.,16,19,10,28,73
2010,DoD,AF,19,27,19,145,210
2010,DoD,ARMY,76,12,11,55,154
2010,DoD,ASBCA,0,0,0,0,0
2010,DoD,DCAA,2,2,0,0,4
2010,DoD,DCMA,0,0,1,1,2
2010,DoD,DeCA,0,0,0,0,0
2010,DoD,DFAS,2,1,0,0,3
2010,DoD,DIA,1,13,10,33,57
2010,DoD,DISA,0,0,0,0,0
2010,DoD,DLA,2,8,1,6,17
2010,DoD,DoDIG,3,11,0,12,26
2010,DoD,DSS,0,0,0,0,0
2010,DoD,DTRA,0,0,0,2,2
2010,DoD,NAVY,84,26,26,191,327
2010,DoD,NGA,4,4,1,2,11
2010,DoD,NRO,3,0,1,2,6
2010,DoD,NSA,37,3,1,15,56
2010,DoD,OSD/JS,13,32,25,78,148
2010,DOE,BPA,0,0,0,0,0
2010,DOE,CBFO,0,0,0,0,0
2010,DOE,CH,0,0,0,0,0
2010,DOE,EMCBC,0,0,0,0,0
2010,DOE,GFO,0,0,0,0,0
2010,DOE,HQ,37,10,10,31,88
2010,DOE,ID,0,0,0,0,0
2010,DOE,NETL,0,0,0,0,0
2010,DOE,NNSA,0,0,0,0,0
2010,DOE,NR,0,0,0,0,0
2010,DOE,NRLFO,0,0,0,0,0
2010,DOE,ORO,0,0,0,0,0
2010,DOE,OSTI,0,0,0,0,0
2010,DOE,ROO,0,0,0,0,0
2010,DOE,SEPA,0,0,0,0,0
2010,DOE,SPR,0,0,0,0,0
2010,DOE,SRO,0,0,0,0,0
2010,DOE,SWPA,0,0,0,0,0
2010,DOE,WAPA,0,0,0,0,0
2010,DOI,Appeals,20,3,72,209,304
2010,DOJ,OIP,1698,206,466,1034,3404
2010,DOJ,USPC,6,1,0,2,9
2010,DOT,FAA,46,15,16,47,124
2010,DOT,FHWA,2,2,2,1,7
2010,DOT,FMCSA,2,3,0,1,6
2010,DOT,FRA,1,0,2,1,4
2010,DOT,FTA,1,0,0,0,1
2010,DOT,MARAD,6,0,0,0,6
2010,DOT,NHTSA,3,7,1,5,16
2010,DOT,OIG,1,2,0,3,6
2010,DOT,OST,2,3,1,1,7
2010,DOT,PHMSA,2,0,1,0,3
2010,DOT,RITA,0,0,0,0,0
2010,DOT,SLSDC,0,0,0,0,0
2010,ED,OM-RIMS,4,4,3,18,29
2010,EEOC,OLC/HDQ,121,86,56,39,302
2010,EPA,HQ,83,33,32,67,215
2010,Ex-Im Bank,HQ,1,0,1,0,2
2010,FCA,FCA,0,0,0,0,0
2010,FCC,FCC,6,3,0,7,16
2010,FCSIC,FCSIC,0,0,0,0,0
2010,FDIC,FDIC,12,7,1,0,20
2010,FEC,FEC,0,0,0,0,0
2010,FERC,FERC,5,1,0,3,9
2010,FFIEC,FFIEC,0,0,0,0,0
2010,FHFA,FHFA,4,0,0,0,4
2010,FLRA,FSIP,0,0,0,0,0
2010,FLRA,Authority,0,1,0,0,1
2010,FLRA,OGC,0,0,0,0,0
2010,FMC,FMC,0,1,0,0,1
2010,FMCS,FMCS,1,0,0,0,1
2010,FMSHRC,FMSHRC,0,0,0,0,0
2010,FOMC,FOMC,1,0,0,0,1
2010,FRB,FRB,8,0,0,1,9
2010,FTC,FTC,7,2,4,0,13
2010,GSA,GSA,16,4,0,1,21
2010,HHS,ACF,0,0,0,0,0
2010,HHS,AOA,0,0,0,0,0
2010,HHS,CMS,0,0,18,127,145
2010,HHS,OIG,0,0,0,0,0
2010,HHS,AHRQ,0,0,0,0,0
2010,HHS,CDC,0,0,0,0,0
2010,HHS,FDA,0,0,0,0,0
2010,HHS,HRSA,0,0,0,0,0
2010,HHS,IHS,0,0,0,0,0
2010,HHS,NIH,0,0,0,0,0
2010,HHS,SAMHSA,0,0,0,0,0
2010,HHS,OS,64,5,7,148,224
2010,HHS,OPHS/PSC,0,0,0,0,0
2010,HUD,HQ,1,0,2,1,4
2010,HUD,OIG,4,1,0,0,5
2010,HUD,R01,0,0,0,0,0
2010,HUD,R02,0,0,1,0,1
2010,HUD,R03,0,0,1,1,2
2010,HUD,R04,0,0,0,0,0
2010,HUD,R05,0,0,0,1,1
2010,HUD,R06,0,1,2,0,3
2010,HUD,R07,0,0,0,0,0
2010,HUD,R08,0,0,0,1,1
2010,HUD,R09,0,0,0,1,1
2010,HUD,R0X,0,0,0,0,0
2010,IAF,IAF,0,0,0,0,0
2010,LSC,LSC,0,0,0,0,0
2010,MCC,MCC,0,0,0,0,0
2010,MSPB,OCB,2,5,0,0,7
2010,NARA,NARA,26,0,4,7,37
2010,NASA,ARC,0,0,0,0,0
2010,NASA,DFRC,0,0,0,0,0
2010,NASA,GRC,0,0,0,0,0
2010,NASA,GSFC,0,0,0,0,0
2010,NASA,HQ,0,0,0,0,0
2010,NASA,JPL,0,0,0,0,0
2010,NASA,JSC,0,0,0,0,0
2010,NASA,KSC,0,0,0,0,0
2010,NASA,LaRC,0,0,0,0,0
2010,NASA,MSFC,0,0,0,0,0
2010,NASA,NSSC,0,0,0,0,0
2010,NASA,OGC,11,3,16,2,32
2010,NASA,OIG,0,0,0,0,0
2010,NASA,SSC,0,0,0,0,0
2010,NCPC,NCPC,0,0,0,0,0
2010,NCUA,NCUA,5,4,2,1,12
2010,NEA,NEA,1,1,0,0,2
2010,NEH,NEH,1,1,0,0,2
2010,NIGC,NIGC,2,0,0,0,2
2010,NLRB,NLRB,15,8,1,3,27
2010,NMB,NMB,2,0,0,0,2
2010,NRPC,NRPC,3,0,0,1,4
2010,NSF,OGC,4,1,0,0,5
2010,NSF,OIG,0,0,0,0,0
2010,NTSB,HQ,3,0,2,2,7
2010,ODNI,ODNI,1,0,0,3,4
2010,OGE,OGE,2,1,1,0,4
2010,OMB,OMB,0,2,3,2,7
2010,ONDCP,OLC,0,0,0,0,0
2010,ONHIR,ONHIR,0,0,0,0,0
2010,OPIC,OPIC,0,4,0,0,4
2010,OPM,OPM,31,1,2,0,34
2010,OSC,OSC,3,12,1,3,19
2010,OSHRC,OSHRC,0,0,0,0,0
2010,OSTP,OSTP,0,1,0,0,1
2010,PBGC,PBGC,2,1,0,0,3
2010,PC,FOIA Office,5,0,0,3,8
2010,PRC,PRC,1,0,0,0,1
2010,SBA,SBA,12,1,5,1,19
2010,SEC,HQ,106,15,52,26,199
2010,SIGAR,SIGAR,0,0,0,0,0
2010,SIGIR,SIGIR,0,1,0,0,1
2010,SSA,SSA,51,6,91,0,148
2010,SSS,SSS,0,0,0,0,0
2010,State,DoS,91,210,6,13,320
2010,STB,STB,0,0,0,0,0
2010,Treasury,BEP,2,0,0,0,2
2010,Treasury,BPD,2,0,0,0,2
2010,Treasury,DO,15,1,2,2,20
2010,Treasury,FinCEN,2,1,0,0,3
2010,Treasury,FMS,4,0,0,0,4
2010,Treasury,IRS,287,1,0,0,288
2010,Treasury,MINT,1,0,1,1,3
2010,Treasury,OCC,2,26,11,7,46
2010,Treasury,OTS,1,6,1,0,8
2010,Treasury,TIGTA,6,10,1,1,18
2010,Treasury,TTB,4,2,0,0,6
2010,TVA,TVA,4,0,0,0,4
2010,U.S. CPSC,U.S. CPSC,12,6,0,6,24
2010,U.S. DOL,ADJ BDS,0,0,0,0,0
2010,U.S. DOL,ALJ,0,0,0,0,0
2010,U.S. DOL,ASP,0,0,0,0,0
2010,U.S. DOL,BLS,0,0,0,2,2
2010,U.S. DOL,CFO,0,0,0,3,3
2010,U.S. DOL,EBSA,2,2,0,12,16
2010,U.S. DOL,ETA,2,1,0,73,76
2010,U.S. DOL,ILAB,0,0,0,0,0
2010,U.S. DOL,MSHA,3,4,0,5,12
2010,U.S. DOL,OASAM,0,0,1,10,11
2010,U.S. DOL,OCIA,0,0,0,0,0
2010,U.S. DOL,ODEP,0,0,0,0,0
2010,U.S. DOL,OFCCP,0,1,0,3,4
2010,U.S. DOL,OIG,1,2,0,4,7
2010,U.S. DOL,OLMS,2,1,0,2,5
2010,U.S. DOL,OPA,0,0,0,0,0
2010,U.S. DOL,OSHA,13,89,2,73,177
2010,U.S. DOL,OWCP,3,1,0,40,44
2010,U.S. DOL,SOL,0,0,1,2,3
2010,U.S. DOL,VETS,0,1,0,6,7
2010,U.S. DOL,WB,0,0,0,0,0
2010,U.S. DOL,WHD,1,7,2,21,31
2010,US ADF,US ADF,0,0,0,0,0
2010,US RRB,OIG,0,0,0,0,0
2010,US RRB,RRB,2,1,0,0,3
2010,USAID,USAID,0,4,0,3,7
2010,USCCR,USCCR,0,0,0,0,0
2010,USDA,AMS,9,0,3,6,18
2010,USDA,APHIS,1,0,0,29,30
2010,USDA,ASCR,0,0,0,0,0
2010,USDA,DM,1,0,0,0,1
2010,USDA,FAS,0,0,0,0,0
2010,USDA,FNCS,2,9,1,1,13
2010,USDA,FS,16,21,0,31,68
2010,USDA,FSA,9,11,3,12,35
2010,USDA,FSIS,0,0,0,0,0
2010,USDA,GIPSA,0,0,1,0,1
2010,USDA,NAD,0,0,0,0,0
2010,USDA,NRCS,0,12,0,0,12
2010,USDA,OBPA,0,0,0,0,0
2010,USDA,OCFO,0,0,0,0,0
2010,USDA,OGC,1,1,0,4,6
2010,USDA,OIG,9,1,0,1,11
2010,USDA,OSEC,0,0,0,1,1
2010,USDA,RD,3,2,1,5,11
2010,USDA,REE,1,0,2,1,4
2010,USDA,RMA,1,1,0,0,2
2010,USIBWC,USIBWC,0,0,0,1,1
2010,USITC,USITC,0,1,0,0,1
2010,USNRC,USNRC,8,6,2,12,28
2010,USPS,PS and PIS,74,17,22,17,130
2010,USPS,OIG,15,4,1,1,21
2010,USTDA,USTDA,0,0,0,0,0
2010,USTR,USTR,1,0,1,0,2
2010,VA,Admin,0,0,0,0,0
2010,VA,BVA,0,0,0,0,0
2010,VA,C&LA,0,0,0,0,0
2010,VA,CFM,0,0,0,0,0
2010,VA,GC,33,35,15,102,185
2010,VA,HRM,0,0,0,0,0
2010,VA,IG,0,0,0,0,0
2010,VA,Mgmt,0,0,0,0,0
2010,VA,NCA,0,0,0,0,0
2010,VA,OAL,0,0,0,0,0
2010,VA,OASHRA,0,0,0,0,0
2010,VA,OASP&IA,0,0,0,0,0
2010,VA,ODASB,0,0,0,0,0
2010,VA,ODASIA,0,0,0,0,0
2010,VA,ODI,0,0,0,0,0
2010,VA,OF,0,0,0,0,0
2010,VA,OI&T,0,0,0,0,0
2010,VA,ORM,0,0,0,0,0
2010,VA,OSDBU,0,0,0,0,0
2010,VA,OSP,0,0,0,0,0
2010,VA,P&P,0,0,0,0,0
2010,VA,PA,0,0,0,0,0
2010,VA,SEC,0,0,0,0,0
2010,VA,VBA,0,0,0,0,0
2010,VA,VHA,0,0,0,0,0
2011,ABMC,ABMC,0,0,0,0,0
2011,ACUS,ACUS,0,0,0,0,0
2011,AFRH,AFRH,1,0,0,0,1
2011,BBG,BBG,4,1,0,1,6
2011,CEQ,CEQ,0,0,0,0,0
2011,CFTC,CFTC,3,0,0,0,3
2011,CIA,CIA,167,19,3,66,255
2011,CIGIE,CIGIE,0,0,0,0,0
2011,CNCS,CNCS,0,0,1,0,1
2011,CO,CO,2,0,0,0,2
2011,CPPBSD,CPPBSD,0,0,0,0,0
2011,CSB,CSB,2,0,1,0,3
2011,CSOSA,CSOSA,0,0,0,0,0
2011,DHS,CBP,116,111,80,36,343
2011,DHS,FLETC,1,0,0,0,1
2011,DHS,ICE,130,13,54,33,230
2011,DHS,OGC,51,12,49,52,164
2011,DHS,OIG,7,4,1,2,14
2011,DHS,TSA,26,6,9,5,46
2011,DHS,USCG,9,0,24,8,41
2011,DHS,USCIS,253,479,217,100,1049
2011,DHS,USSS,25,13,6,1,45
2011,DNFSB,OGC,0,0,0,0,0
2011,DNFSB,OGM,0,0,0,0,0
2011,DOC,PTO,1,1,1,3,6
2011,DOC,AGC/Admin.,25,25,23,29,102
2011,DoD,AF,36,20,13,100,169
2011,DoD,ARMY,68,7,6,58,139
2011,DoD,ASBCA,0,0,0,0,0
2011,DoD,DCAA,1,0,1,0,2
2011,DoD,DCMA,1,2,0,3,6
2011,DoD,DeCA,0,0,0,0,0
2011,DoD,DFAS,0,0,0,1,1
2011,DoD,DIA,21,8,12,41,82
2011,DoD,DISA,0,0,0,1,1
2011,DoD,DLA,2,0,3,4,9
2011,DoD,DoD IG,3,3,0,9,15
2011,DoD,DSS,0,0,0,0,0
2011,DoD,DTRA,0,0,0,0,0
2011,DoD,NAVY,60,16,36,202,314
2011,DoD,NGA,4,3,2,1,10
2011,DoD,NRO,5,3,0,0,8
2011,DoD,NSA,20,3,1,4,28
2011,DoD,OSD/JS,27,18,31,47,123
2011,DOE,BPA,0,0,0,0,0
2011,DOE,CBFO,0,0,0,0,0
2011,DOE,CH,0,0,0,0,0
2011,DOE,EMCBC,0,0,0,0,0
2011,DOE,GFO,0,0,0,0,0
2011,DOE,HQ,34,7,10,19,70
2011,DOE,ID,0,0,0,0,0
2011,DOE,NETL,0,0,0,0,0
2011,DOE,NNSA,0,0,0,0,0
2011,DOE,NR,0,0,0,0,0
2011,DOE,NRLFO,0,0,0,0,0
2011,DOE,ORO,0,0,0,0,0
2011,DOE,OSTI,0,0,0,0,0
2011,DOE,ROO,0,0,0,0,0
2011,DOE,SEPA,0,0,0,0,0
2011,DOE,SPR,0,0,0,0,0
2011,DOE,SRO,0,0,0,0,0
2011,DOE,SWPA,0,0,0,0,0
2011,DOE,WAPA,0,0,0,0,0
2011,DOI,Appeals,28,11,44,147,230
2011,DOJ,OIP,1960,183,428,783,3354
2011,DOJ,USPC,5,2,1,0,8
2011,DOT,FAA,36,14,46,32,128
2011,DOT,FHWA,0,1,1,4,6
2011,DOT,FMCSA,0,3,0,3,6
2011,DOT,FRA,2,0,0,0,2
2011,DOT,FTA,1,0,0,1,2
2011,DOT,MARAD,0,4,0,0,4
2011,DOT,NHTSA,4,4,0,2,10
2011,DOT,OIG,1,1,1,1,4
2011,DOT,OST,1,1,1,1,4
2011,DOT,PHMSA,0,1,0,1,2
2011,DOT,RITA,0,0,0,1,1
2011,DOT,SLSDC,0,0,0,0,0
2011,ED,OM-PIRMS,3,0,5,7,15
2011,EEOC,OLC/HDQ,350,117,62,73,602
2011,EPA,HQ,77,27,49,55,208
2011,EPA,Region 1,0,0,0,0,0
2011,EPA,Region 2,0,0,0,0,0
2011,EPA,Region 3,0,0,0,0,0
2011,EPA,Region 4,0,0,0,0,0
2011,EPA,Region 5,0,0,0,0,0
2011,EPA,Region 6,0,0,0,0,0
2011,EPA,Region 7,0,0,0,0,0
2011,EPA,Region 8,0,0,0,0,0
2011,EPA,Region 9,0,0,0,0,0
2011,EPA,Region 10,0,0,0,0,0
2011,Ex-Im Bank,HQ,0,0,0,0,0
2011,FCA,FCA,0,0,0,0,0
2011,FCC,FCC,10,2,0,5,17
2011,FCSIC,FCSIC,0,0,0,0,0
2011,FDIC,FDIC,26,7,3,2,38
2011,FEC,FEC,1,2,0,0,3
2011,FERC,FERC,4,2,4,4,14
2011,FFIEC,FFIEC,0,0,0,0,0
2011,FHFA,FHFA FOIA,9,3,0,0,12
2011,FLRA,FSIP,0,0,0,0,0
2011,FLRA,Authority,4,0,0,1,5
2011,FLRA,OGC,1,0,2,0,3
2011,FMC,FMC,0,1,0,0,1
2011,FMCS,FMCS,0,0,0,0,0
2011,FMSHRC,FMSHRC,0,0,0,0,0
2011,FOMC,FOMC,1,0,0,0,1
2011,FRB,FRB,12,2,0,3,17
2011,FRTIB,FRTIB,0,0,0,0,0
2011,FTC,FTC,17,5,2,1,25
2011,GSA,GSA,19,0,0,2,21
2011,HHS,CMS,1,0,7,112,120
2011,HHS,OS,109,14,13,63,199
2011,HUD,HQ,6,1,6,4,17
2011,HUD,OIG,4,5,1,1,11
2011,HUD,R01,0,0,0,0,0
2011,HUD,R02,0,1,1,0,2
2011,HUD,R03,0,0,0,1,1
2011,HUD,R04,0,0,0,0,0
2011,HUD,R05,1,0,2,0,3
2011,HUD,R06,0,1,0,1,2
2011,HUD,R07,0,0,0,0,0
2011,HUD,R08,0,0,1,0,1
2011,HUD,R09,0,0,0,0,0
2011,HUD,R0X,0,0,0,0,0
2011,IAF,IAF,0,0,0,0,0
2011,IMLS,IMLS,0,0,0,0,0
2011,LSC,LSC,1,1,0,0,2
2011,MCC,MCC,0,1,0,0,1
2011,MSPB,MSPB,3,4,1,0,8
2011,NARA,NARA,35,9,11,9,64
2011,NASA,ARC,0,0,0,0,0
2011,NASA,DFRC,0,0,0,0,0
2011,NASA,GRC,0,0,0,0,0
2011,NASA,GSFC,0,0,0,0,0
2011,NASA,HQ,0,0,0,0,0
2011,NASA,JPL,0,0,0,0,0
2011,NASA,JSC,0,0,0,0,0
2011,NASA,KSC,0,0,0,0,0
2011,NASA,LaRC,0,0,0,0,0
2011,NASA,MSFC,0,0,0,0,0
2011,NASA,NSSC,0,0,0,0,0
2011,NASA,OGC,8,6,3,4,21
2011,NASA,OIG,2,0,0,0,2
2011,NASA,SSC,0,0,0,0,0
2011,NCPC,NCPC,0,0,1,0,1
2011,NCUA,NCUA,7,3,0,0,10
2011,NEA,NEA,1,1,0,2,4
2011,NEH,NEH,0,0,0,1,1
2011,NIGC,NIGC,1,0,0,1,2
2011,NLRB,NLRB,40,6,2,10,58
2011,NMB,NMB,0,0,0,0,0
2011,NRPC,NRPC,3,0,0,4,7
2011,NSF,OGC,7,2,1,1,11
2011,NSF,OIG,8,0,1,1,10
2011,NTSB,NTSB,3,1,0,6,10
2011,ODNI,ODNI,2,0,0,1,3
2011,OGE,OGE,1,2,0,0,3
2011,OMB,OMB,8,1,0,1,10
2011,ONDCP,ONDCP,1,0,0,0,1
2011,ONHIR,ONHIR,0,0,0,0,0
2011,OPIC,OPIC,0,1,1,0,2
2011,OPM,OPM,12,7,5,2,26
2011,OSC,OSC,4,3,0,0,7
2011,OSHRC,OSHRC,0,0,0,0,0
2011,OSTP,OSTP,5,0,0,1,6
2011,PBGC,PBGC,3,0,1,1,5
2011,PC,FOIA Office,6,2,0,2,10
2011,PC,OIG,1,0,0,0,1
2011,PRC,PRC,0,0,0,0,0
2011,RATB,RATB,0,0,0,0,0
2011,SBA,SBA,6,9,0,7,22
2011,SEC,SEC,86,16,36,24,162
2011,SIGAR,SIGAR,1,0,0,0,1
2011,SIGIR,SIGIR,0,0,0,0,0
2011,SSA,SSA,27,7,66,0,100
2011,SSS,SSS,0,0,0,0,0
2011,State,DoS,104,227,22,28,381
2011,State,OIG,0,0,0,0,0
2011,STB,STB,0,0,0,0,0
2011,Treasury,BEP,0,1,0,0,1
2011,Treasury,BPD,3,1,1,0,5
2011,Treasury,CFPB,0,0,0,0,0
2011,Treasury,DO,23,4,6,4,37
2011,Treasury,FinCEN,9,1,0,0,10
2011,Treasury,FMS,1,0,0,0,1
2011,Treasury,IRS,218,1,3,8,230
2011,Treasury,MINT,2,1,0,1,4
2011,Treasury,OCC,1,15,11,8,35
2011,Treasury,OTS,1,1,1,2,5
2011,Treasury,TIGTA,11,7,1,2,21
2011,Treasury,TTB,4,1,0,0,5
2011,TVA,TVA,1,1,0,2,4
2011,U.S. CPSC,U.S. CPSC,12,2,1,6,21
2011,U.S. DOL,ADJ BDS,0,0,0,0,0
2011,U.S. DOL,ALJ,0,0,0,2,2
2011,U.S. DOL,ASP,0,0,0,0,0
2011,U.S. DOL,BLS,0,0,0,0,0
2011,U.S. DOL,CFO,0,0,0,0,0
2011,U.S. DOL,EBSA,0,1,1,8,10
2011,U.S. DOL,ETA,0,0,0,57,57
2011,U.S. DOL,EXEC SEC,0,0,0,0,0
2011,U.S. DOL,ILAB,0,0,0,0,0
2011,U.S. DOL,MSHA,2,5,1,16,24
2011,U.S. DOL,OASAM,1,0,1,9,11
2011,U.S. DOL,OCIA,0,0,0,0,0
2011,U.S. DOL,ODEP,0,0,0,0,0
2011,U.S. DOL,OFCCP,1,1,0,6,8
2011,U.S. DOL,OIG,0,0,0,0,0
2011,U.S. DOL,OLMS,1,2,0,10,13
2011,U.S. DOL,OPA,0,0,0,0,0
2011,U.S. DOL,OSEC,0,0,0,0,0
2011,U.S. DOL,OSHA,9,67,3,83,162
2011,U.S. DOL,OWCP,0,3,0,52,55
2011,U.S. DOL,SOL,0,0,0,2,2
2011,U.S. DOL,VETS,0,5,0,4,9
2011,U.S. DOL,WB,0,0,0,0,0
2011,U.S. DOL,WHD,3,5,0,32,40
2011,US ADF,US ADF,0,0,0,0,0
2011,US RRB,OIG,0,0,0,0,0
2011,US RRB,RRB,3,1,0,0,4
2011,USAID,USAID,0,1,0,2,3
2011,USCCR,USCCR,0,0,0,0,0
2011,USDA,AMS,0,2,3,1,6
2011,USDA,APHIS,2,1,0,8,11
2011,USDA,ASCR,2,0,1,0,3
2011,USDA,DM,1,0,0,0,1
2011,USDA,FAS,0,0,0,0,0
2011,USDA,FNCS,17,7,0,6,30
2011,USDA,FS,10,15,2,27,54
2011,USDA,FSA,7,12,5,5,29
2011,USDA,FSIS,0,0,0,1,1
2011,USDA,GIPSA,0,0,0,1,1
2011,USDA,NAD,0,0,0,0,0
2011,USDA,NRCS,11,2,0,2,15
2011,USDA,OBPA,0,0,0,0,0
2011,USDA,OCFO,0,0,0,0,0
2011,USDA,OGC,1,1,0,1,3
2011,USDA,OIG,5,3,2,2,12
2011,USDA,OSEC/OCIO,0,0,0,2,2
2011,USDA,RD,5,8,4,4,21
2011,USDA,REE,1,0,1,0,2
2011,USDA,RMA,1,0,0,0,1
2011,USIBWC,USIBWC,1,1,0,0,2
2011,USITC,USITC,0,1,0,0,1
2011,USNRC,USNRC,8,2,0,4,14
2011,USPS,OIG,13,2,1,2,18
2011,USPS,PS & PIS,27,16,29,30,102
2011,USTDA,USTDA,0,0,1,1,2
2011,USTR,USTR,2,3,0,0,5
2011,VA,GC,36,39,22,132,229
2012,ABMC,ABMC,0,0,0,0,0
2012,ACUS,ACUS,0,0,0,0,0
2012,AFRH,AFRH,0,0,0,0,0
2012,BBG,BBG,1,0,3,0,4
2012,CEQ,CEQ,0,1,0,0,1
2012,CFTC,CFTC,1,1,1,0,3
2012,CIA,CIA,163,19,6,114,302
2012,CIGIE,CIGIE,0,1,0,0,1
2012,CNCS,CNCS,0,1,0,0,1
2012,CO,CO,0,0,0,0,0
2012,CPPBSD,CPPBSD,0,0,0,0,0
2012,CSB,CSB,1,0,0,0,1
2012,CSOSA,CSOSA,2,0,0,0,2
2012,DHS,CBP,118,120,111,127,476
2012,DHS,FLETC,1,0,0,0,1
2012,DHS,ICE,168,63,0,72,303
2012,DHS,OGC,72,17,27,45,161
2012,DHS,OIG,8,2,1,8,19
2012,DHS,TSA,13,2,6,4,25
2012,DHS,USCG,29,0,12,10,51
2012,DHS,USCIS,501,605,231,94,1431
2012,DHS,USSS,1,1,2,19,23
2012,DNFSB,OGC,0,0,0,0,0
2012,DNFSB,OGM,0,0,0,0,0
2012,DOC,PTO,5,3,1,1,10
2012,DOC,AGC/Admin,10,30,27,19,86
2012,DoD,AF,67,32,11,109,219
2012,DoD,ARMY,72,8,7,38,125
2012,DoD,ASBCA,0,0,0,0,0
2012,DoD,DCAA,2,1,0,0,3
2012,DoD,DCMA,3,1,0,2,6
2012,DoD,DeCA,0,0,0,0,0
2012,DoD,DFAS,1,1,0,4,6
2012,DoD,DIA,68,33,6,56,163
2012,DoD,DISA,0,0,0,1,1
2012,DoD,DLA,2,2,2,12,18
2012,DoD,DoD IG,10,1,0,9,20
2012,DoD,DSS,0,0,0,0,0
2012,DoD,DTRA,0,0,1,0,1
2012,DoD,NAVY,125,31,17,115,288
2012,DoD,NGA,0,0,0,0,0
2012,DoD,NRO,2,1,1,3,7
2012,DoD,NSA,35,1,0,8,44
2012,DoD,OSD/JS,32,36,23,88,179
2012,DOE,BPA,0,0,0,0,0
2012,DOE,CBFO,0,0,0,0,0
2012,DOE,CH,0,0,0,0,0
2012,DOE,EMCBC,0,0,0,0,0
2012,DOE,GFO,0,0,0,0,0
2012,DOE,HQ,34,7,12,20,73
2012,DOE,ID,0,0,0,0,0
2012,DOE,NETL,0,0,0,0,0
2012,DOE,NNSA,0,0,0,0,0
2012,DOE,NR,0,0,0,0,0
2012,DOE,NRLFO,0,0,0,0,0
2012,DOE,ORO,0,0,0,0,0
2012,DOE,OSTI,0,0,0,0,0
2012,DOE,ROO,0,0,0,0,0
2012,DOE,SEPA,0,0,0,0,0
2012,DOE,SPR,0,0,0,0,0
2012,DOE,SRO,0,0,0,0,0
2012,DOE,SWPA,0,0,0,0,0
2012,DOE,WAPA,0,0,0,0,0
2012,DOI,FOIA/PA Appeals,23,13,105,84,225
2012,DOJ,OIP,1974,173,387,869,3403
2012,DOJ,USPC,2,7,0,0,9
2012,DOT,FAA,30,17,47,34,128
2012,DOT,FHWA,1,5,0,3,9
2012,DOT,FMCSA,0,3,2,0,5
2012,DOT,FRA,1,1,0,0,2
2012,DOT,FTA,3,4,2,3,12
2012,DOT,MARAD,0,0,0,0,0
2012,DOT,NHTSA,2,0,1,4,7
2012,DOT,OIG,0,0,0,0,0
2012,DOT,OST,3,2,1,3,9
2012,DOT,PHMSA,0,0,0,0,0
2012,DOT,RITA,0,1,0,0,1
2012,DOT,SLSDC,0,0,0,0,0
2012,ED,OM-PIRMS,18,7,4,5,34
2012,EEOC,OLC/HDQ,215,112,53,0,380
2012,EPA,HQ,97,45,36,68,246
2012,Ex-Im Bank,HQ,0,0,0,0,0
2012,FCA,FCA,0,0,0,0,0
2012,FCC,FCC,9,5,1,8,23
2012,FCSIC,FCSIC,0,0,0,0,0
2012,FDIC,FDIC,28,6,1,5,40
2012,FEC,FEC,3,0,0,1,4
2012,FERC,FERC,4,0,0,1,5
2012,FFIEC,FFIEC,1,0,0,0,1
2012,FHFA,FHFA FOIA,6,3,0,1,10
2012,FHFA,FHFA-OIG,1,0,0,0,1
2012,FLRA,FSIP,0,0,0,0,0
2012,FLRA,Authority,0,0,0,0,0
2012,FLRA,OGC,0,2,0,0,2
2012,FMC,FMC,0,0,0,0,0
2012,FMCS,FMCS,1,0,0,0,1
2012,FMSHRC,FMSHRC,0,0,0,0,0
2012,FOMC,FOMC,1,0,0,0,1
2012,FRB,FRB,3,12,0,3,18
2012,FRTIB,FRTIB,0,0,0,0,0
2012,FTC,FTC,17,6,5,4,32
2012,GSA,GSA,13,7,1,7,28
2012,HHS,CMS,0,1,2,50,53
2012,HHS,OS,81,23,11,77,192
2012,HUD,HQ,19,5,6,2,32
2012,HUD,OIG,3,1,4,2,10
2012,HUD,R01,0,0,0,0,0
2012,HUD,R02,0,0,0,1,1
2012,HUD,R03,0,0,0,0,0
2012,HUD,R04,1,1,1,0,3
2012,HUD,R05,0,0,1,0,1
2012,HUD,R06,2,1,1,0,4
2012,HUD,R07,0,0,0,0,0
2012,HUD,R08,0,0,1,0,1
2012,HUD,R09,0,1,0,0,1
2012,HUD,R0X,0,0,0,0,0
2012,IAF,IAF,0,0,0,0,0
2012,IMLS,IMLS,0,0,0,0,0
2012,LSC,OLA,1,1,0,0,2
2012,LSC,OIG,0,0,0,0,0
2012,MCC,MCC,1,0,0,0,1
2012,MSPB,MSPB,12,4,5,1,22
2012,NARA,NARA,45,6,9,0,60
2012,NASA,ARC,0,0,0,0,0
2012,NASA,DFRC,0,0,0,0,0
2012,NASA,GRC,0,0,0,0,0
2012,NASA,GSFC,0,0,0,0,0
2012,NASA,HQ,0,0,0,0,0
2012,NASA,JPL,0,0,0,0,0
2012,NASA,JSC,0,0,0,0,0
2012,NASA,KSC,0,0,0,0,0
2012,NASA,LaRC,0,0,0,0,0
2012,NASA,MSFC,0,0,0,0,0
2012,NASA,NSSC,0,0,0,0,0
2012,NASA,OGC,12,6,2,1,21
2012,NASA,OIG,1,2,0,0,3
2012,NASA,SSC,0,0,0,0,0
2012,NCPC,NCPC,2,0,0,0,2
2012,NCUA,NCUA,5,2,1,0,8
2012,NEA,NEA,1,0,0,0,1
2012,NEH,NEH,2,0,0,0,2
2012,NIGC,NIGC,0,0,0,0,0
2012,NLRB,NLRB,41,10,1,2,54
2012,NMB,NMB,0,0,0,0,0
2012,NRPC,NRPC,1,0,0,2,3
2012,NSF,OGC,1,2,1,0,4
2012,NSF,OIG,5,3,0,0,8
2012,NTSB,NTSB,3,0,4,0,7
2012,ODNI,ODNI,5,1,0,6,12
2012,OGE,OGE,4,0,0,0,4
2012,OMB,OMB,7,6,1,3,17
2012,ONDCP,ONDCP,0,0,0,0,0
2012,ONHIR,ONHIR,0,0,0,0,0
2012,OPIC,OPIC,4,0,0,0,4
2012,OPM,OPM,12,7,2,13,34
2012,OSC,OSC,3,2,1,0,6
2012,OSHRC,OSHRC,0,0,0,0,0
2012,OSTP,OSTP,5,3,0,0,8
2012,PBGC,PBGC,6,2,0,0,8
2012,PC,FOIA Office,7,1,1,2,11
2012,PC,OIG,0,0,0,0,0
2012,PRC,PRC,0,0,0,0,0
2012,RATB,RATB,0,1,0,0,1
2012,SBA,SBA,7,8,3,4,22
2012,SEC,SEC,69,6,28,18,121
2012,SIGAR,SIGAR,0,0,0,0,0
2012,SIGIR,SIGIR,0,1,0,0,1
2012,SSA,SSA,394,72,378,0,844
2012,SSS,SSS,0,0,0,0,0
2012,State,DoS,61,52,15,2,130
2012,State,OIG,0,0,0,0,0
2012,STB,STB,0,0,0,0,0
2012,Treasury,BEP,0,0,0,0,0
2012,Treasury,BPD,0,0,0,0,0
2012,Treasury,CFPB,6,1,1,0,8
2012,Treasury,DO,9,6,4,3,22
2012,Treasury,FinCEN,11,1,0,1,13
2012,Treasury,FMS,5,2,0,0,7
2012,Treasury,IRS,178,0,0,0,178
2012,Treasury,MINT,2,1,0,0,3
2012,Treasury,OCC,11,25,10,8,54
2012,Treasury,TIGTA,17,6,1,1,25
2012,Treasury,TTB,0,1,0,0,1
2012,TVA,TVA,6,0,0,0,6
2012,U.S. CPSC,U.S. CPSC,14,5,0,0,19
2012,U.S. DOL,ADJ BDS,0,0,0,0,0
2012,U.S. DOL,ALJ,0,2,0,0,2
2012,U.S. DOL,ASP,0,0,0,0,0
2012,U.S. DOL,BLS,0,0,0,0,0
2012,U.S. DOL,CFO,0,0,0,0,0
2012,U.S. DOL,EBSA,1,0,1,4,6
2012,U.S. DOL,ETA,0,0,15,34,49
2012,U.S. DOL,EXEC SEC,0,0,0,0,0
2012,U.S. DOL,ILAB,0,0,0,0,0
2012,U.S. DOL,MSHA,3,5,7,10,25
2012,U.S. DOL,OASAM,1,0,1,8,10
2012,U.S. DOL,OCIA,0,0,0,0,0
2012,U.S. DOL,ODEP,0,0,0,0,0
2012,U.S. DOL,OFCCP,0,3,2,5,10
2012,U.S. DOL,OIG,0,1,0,0,1
2012,U.S. DOL,OLMS,0,0,1,3,4
2012,U.S. DOL,OPA,0,0,0,0,0
2012,U.S. DOL,OSEC,0,0,0,0,0
2012,U.S. DOL,OSHA,10,39,19,41,109
2012,U.S. DOL,OWCP,2,0,22,74,98
2012,U.S. DOL,SOL,1,0,0,1,2
2012,U.S. DOL,VETS,0,1,0,0,1
2012,U.S. DOL,WB,0,0,0,0,0
2012,U.S. DOL,WHD,1,3,11,22,37
2012,US ADF,US ADF,0,0,0,0,0
2012,US RRB,OIG,0,0,0,0,0
2012,US RRB,RRB,2,0,0,0,2
2012,USAID,USAID,3,0,0,2,5
2012,USCCR,USCCR,0,0,0,0,0
2012,USDA,AMS,3,3,1,1,8
2012,USDA,APHIS,1,1,1,20,23
2012,USDA,ASCR,1,0,0,0,1
2012,USDA,DM,0,0,1,0,1
2012,USDA,FAS,0,0,0,0,0
2012,USDA,FNCS,15,7,0,2,24
2012,USDA,FS,10,13,6,28,57
2012,USDA,FSA,4,9,4,5,22
2012,USDA,FSIS,0,0,6,1,7
2012,USDA,GIPSA,2,1,0,0,3
2012,USDA,NAD,0,0,0,0,0
2012,USDA,NRCS,3,8,1,1,13
2012,USDA,OBPA,0,0,0,0,0
2012,USDA,OCFO,1,0,0,1,2
2012,USDA,OGC,0,0,0,1,1
2012,USDA,OIG,5,1,3,3,12
2012,USDA,OSEC/OCIO,0,1,2,0,3
2012,USDA,RD,0,0,0,1,1
2012,USDA,REE,0,1,0,0,1
2012,USDA,RMA,0,0,1,0,1
2012,USIBWC,USIBWC,0,0,0,0,0
2012,USITC,USITC,0,0,0,0,0
2012,USNRC,USNRC,4,1,4,1,10
2012,USPS,OIG,13,4,0,1,18
2012,USPS,PS & PIS,33,14,31,43,121
2012,USTDA,USTDA,0,0,0,0,0
2012,USTR,USTR,0,1,0,0,1
2012,VA,GC,64,42,20,227,353
2013,ABMC,ABMC,0,0,0,0,0
2013,ACUS,ACUS,0,0,0,0,0
2013,AFRH,AFRH,0,0,0,0,0
2013,BBG,BBG,2,0,0,0,2
2013,CEQ,CEQ,1,0,0,0,1
2013,CFPB,CFPB,12,3,3,2,20
2013,CFTC,CFTC,4,0,1,1,6
2013,CIA,CIA,223,29,4,104,360
2013,CIGIE,CIGIE,1,1,0,1,3
2013,CNCS,CNCS,0,0,0,1,1
2013,CO,CO,0,0,0,0,0
2013,CPPBSD,CPPBSD,0,0,0,0,0
2013,CSB,CSB,0,0,0,0,0
2013,CSOSA,CSOSA,0,0,0,0,0
2013,DHS,CBP,51,49,151,103,354
2013,DHS,FEMA,13,3,2,27,45
2013,DHS,FLETC,4,0,0,1,5
2013,DHS,ICE,110,8,107,92,317
2013,DHS,OGC,85,9,14,71,179
2013,DHS,OIG,0,0,1,2,3
2013,DHS,TSA,11,2,6,3,22
2013,DHS,USCG,9,0,24,12,45
2013,DHS,USCIS,571,850,380,200,2001
2013,DHS,USSS,28,29,8,10,75
2013,DNFSB,DNFSB,0,0,0,0,0
2013,DOC,PTO,16,8,2,2,28
2013,DOC,AGC/Admin.,20,14,4,10,48
2013,DoD,AF,26,34,13,103,176
2013,DoD,ARMY,50,8,11,37,106
2013,DoD,ASBCA,0,0,0,0,0
2013,DoD,DCAA,1,5,0,0,6
2013,DoD,DCMA,3,2,0,1,6
2013,DoD,DeCA,0,0,0,0,0
2013,DoD,DFAS,1,0,0,1,2
2013,DoD,DIA,95,39,3,18,155
2013,DoD,DISA,0,0,0,0,0
2013,DoD,DLA,3,9,0,1,13
2013,DoD,DoD IG,16,1,5,7,29
2013,DoD,DSS,0,0,0,1,1
2013,DoD,DTRA,0,1,0,2,3
2013,DoD,NAVY,101,26,30,155,312
2013,DoD,NGA,2,0,0,0,2
2013,DoD,NRO,3,1,0,2,6
2013,DoD,NSA,82,1,0,16,99
2013,DoD,OSD/JS,45,42,37,105,229
2013,DOE,BPA,0,0,0,0,0
2013,DOE,CBFO,0,0,0,0,0
2013,DOE,CH,0,0,0,0,0
2013,DOE,EMCBC,0,0,0,0,0
2013,DOE,GFO,0,0,0,0,0
2013,DOE,HQ,42,15,6,17,80
2013,DOE,ID,0,0,0,0,0
2013,DOE,NETL,0,0,0,0,0
2013,DOE,NNSA,0,0,0,0,0
2013,DOE,NR,0,0,0,0,0
2013,DOE,NRLFO,0,0,0,0,0
2013,DOE,ORO,0,0,0,0,0
2013,DOE,OSTI,0,0,0,0,0
2013,DOE,ROO,0,0,0,0,0
2013,DOE,SEPA,0,0,0,0,0
2013,DOE,SPR,0,0,0,0,0
2013,DOE,SRO,0,0,0,0,0
2013,DOE,SWPA,0,0,0,0,0
2013,DOE,WAPA,0,0,0,0,0
2013,DOI,FOIA/PA Appeals,43,7,41,86,177
2013,DOJ,OIP,2050,125,359,864,3398
2013,DOJ,USPC,0,0,0,0,0
2013,DOT,FAA,21,17,45,0,83
2013,DOT,FHWA,1,3,1,11,16
2013,DOT,FMCSA,1,0,0,3,4
2013,DOT,FRA,4,0,0,0,4
2013,DOT,FTA,0,0,1,0,1
2013,DOT,MARAD,2,2,0,0,4
2013,DOT,NHTSA,5,1,3,0,9
2013,DOT,OIG,0,2,0,3,5
2013,DOT,OST,3,1,0,0,4
2013,DOT,PHMSA,0,0,0,0,0
2013,DOT,RITA,0,0,0,0,0
2013,DOT,SLSDC,0,0,0,0,0
2013,ED,OM-PIRMS,10,4,2,4,20
2013,EEOC,OLC/HDQ,159,76,56,0,291
2013,EPA,HQ,159,0,0,23,182
2013,EPA,Region 1,0,0,0,0,0
2013,EPA,Region 2,0,0,0,0,0
2013,EPA,Region 3,0,0,0,0,0
2013,EPA,Region 4,0,0,0,0,0
2013,EPA,Region 5,1,0,0,0,1
2013,EPA,Region 6,0,0,0,1,1
2013,EPA,Region 7,0,0,0,0,0
2013,EPA,Region 8,0,0,0,0,0
2013,EPA,Region 9,0,0,0,0,0
2013,EPA,Region 10,0,0,0,0,0
2013,Ex-Im Bank,HQ,1,1,0,0,2
2013,FCA,FCA,1,0,0,0,1
2013,FCC,FCC,8,0,0,8,16
2013,FCSIC,FCSIC,0,0,0,0,0
2013,FDIC,FDIC,23,8,1,2,34
2013,FEC,FEC,0,0,0,1,1
2013,FERC,FERC,6,4,1,1,12
2013,FFIEC,FFIEC,0,0,0,0,0
2013,FHFA,FHFA-HQ,5,5,0,1,11
2013,FHFA,FHFA-OIG,0,1,0,1,2
2013,FLRA,FSIP,0,0,0,0,0
2013,FLRA,Authority,0,0,0,0,0
2013,FLRA,IG,0,0,0,0,0
2013,FLRA,OGC,3,0,0,0,3
2013,FLRA,ATRO,0,0,0,0,0
2013,FLRA,BORO,0,0,0,0,0
2013,FLRA,CHRO,0,0,0,0,0
2013,FLRA,DARO,0,0,0,0,0
2013,FLRA,DERO,0,0,0,0,0
2013,FLRA,SFRO,0,0,0,0,0
2013,FLRA,WARO,0,0,0,0,0
2013,FMC,FMC,0,0,0,0,0
2013,FMCS,FMCS,1,0,0,0,1
2013,FMSHRC,FMSHRC,0,1,0,0,1
2013,FOMC,FOMC,0,0,0,0,0
2013,FRB,FRB,20,10,0,7,37
2013,FRTIB,FRTIB,0,1,0,0,1
2013,FTC,FTC,4,5,5,12,26
2013,GSA,GSA,13,8,0,2,23
2013,HHS,CMS,16,2,21,20,59
2013,HHS,OS,51,17,6,148,222
2013,HUD,HQ,18,2,4,0,24
2013,HUD,OIG,1,0,0,0,1
2013,HUD,R01,1,0,0,0,1
2013,HUD,R02,0,0,0,0,0
2013,HUD,R03,2,2,0,0,4
2013,HUD,R04,3,0,1,0,4
2013,HUD,R05,1,0,2,0,3
2013,HUD,R06,2,1,0,0,3
2013,HUD,R07,0,1,0,0,1
2013,HUD,R08,0,0,1,0,1
2013,HUD,R09,1,1,2,0,4
2013,HUD,R0X,1,0,0,0,1
2013,IAF,IAF,0,0,0,0,0
2013,IMLS,IMLS,1,0,0,0,1
2013,LSC,OLA,1,0,0,0,1
2013,LSC,OIG,0,0,0,0,0
2013,MCC,MCC,0,1,0,0,1
2013,MSPB,MSPB,6,4,2,6,18
2013,NARA,NARA,39,13,5,6,63
2013,NASA,ARC,0,0,0,0,0
2013,NASA,DFRC,0,0,0,0,0
2013,NASA,GRC,0,0,0,0,0
2013,NASA,GSFC,0,0,0,0,0
2013,NASA,HQ,0,0,0,0,0
2013,NASA,JPL,0,0,0,0,0
2013,NASA,JSC,0,0,0,0,0
2013,NASA,KSC,0,0,0,0,0
2013,NASA,LaRC,0,0,0,0,0
2013,NASA,MSFC,0,0,0,0,0
2013,NASA,NSSC,0,0,0,0,0
2013,NASA,OGC,8,5,2,1,16
2013,NASA,OIG,0,0,0,0,0
2013,NASA,SSC,0,0,0,0,0
2013,NCPC,NCPC,0,0,0,0,0
2013,NCUA,NCUA,3,2,0,0,5
2013,NEA,NEA,0,0,0,1,1
2013,NEH,NEH,0,0,0,0,0
2013,NIGC,NIGC,1,1,1,0,3
2013,NLRB,NLRB,14,11,1,0,26
2013,NMB,NMB,0,0,0,0,0
2013,NRPC,NRPC,0,1,1,0,2
2013,NSF,OGC,2,0,0,0,2
2013,NSF,OIG,1,0,1,0,2
2013,NTSB,NTSB,0,2,0,2,4
2013,ODNI,ODNI,11,0,1,11,23
2013,OGE,OGE,1,0,1,0,2
2013,OMB,OMB,4,0,0,0,4
2013,ONDCP,ONDCP,0,0,0,0,0
2013,ONHIR,ONHIR,0,0,0,0,0
2013,OPIC,OPIC,0,0,1,0,1
2013,OPM,OPM,26,6,5,2,39
2013,OSC,OSC,6,1,1,0,8
2013,OSHRC,OSHRC,0,0,0,0,0
2013,OSTP,OSTP,3,0,1,1,5
2013,PBGC,PBGC,2,1,0,0,3
2013,PC,FOIA Office,1,2,0,2,5
2013,PC,OIG,1,0,0,0,1
2013,PRC,PRC,0,0,0,0,0
2013,RATB,RATB,0,1,0,0,1
2013,SBA,SBA,4,3,5,0,12
2013,SEC,SEC,88,12,22,27,149
2013,SIGAR,SIGAR,0,0,0,1,1
2013,SSA,SSA,178,54,227,0,459
2013,SSS,SSS,0,0,0,0,0
2013,State,DoS,207,84,27,49,367
2013,State,OIG,1,2,0,0,3
2013,STB,STB,0,0,0,0,0
2013,Treasury,BEP,1,0,1,0,2
2013,Treasury,BPD,4,0,0,0,4
2013,Treasury,DO,6,4,1,2,13
2013,Treasury,FinCEN,12,1,0,1,14
2013,Treasury,FMS,9,2,0,1,12
2013,Treasury,IRS,229,3,3,0,235
2013,Treasury,MINT,2,3,0,0,5
2013,Treasury,OCC,9,8,2,8,27
2013,Treasury,TIGTA,21,13,0,0,34
2013,Treasury,TTB,0,0,0,0,0
2013,TVA,TVA,6,1,0,2,9
2013,U.S. CPSC,U.S. CPSC,8,4,0,0,12
2013,U.S. DOL,ADJ BDS,0,0,1,0,1
2013,U.S. DOL,ALJ,0,0,0,1,1
2013,U.S. DOL,ASP,0,0,0,0,0
2013,U.S. DOL,BLS,0,0,1,1,2
2013,U.S. DOL,CFO,0,0,0,0,0
2013,U.S. DOL,EBSA,0,0,1,3,4
2013,U.S. DOL,ETA,0,0,19,21,40
2013,U.S. DOL,EXEC SEC,0,0,0,0,0
2013,U.S. DOL,ILAB,0,0,0,0,0
2013,U.S. DOL,MSHA,0,0,4,4,8
2013,U.S. DOL,OASAM,0,1,4,2,7
2013,U.S. DOL,OCIA,0,0,0,0,0
2013,U.S. DOL,ODEP,0,0,0,0,0
2013,U.S. DOL,OFCCP,0,2,3,1,6
2013,U.S. DOL,OIG,0,0,1,1,2
2013,U.S. DOL,OLMS,0,6,1,2,9
2013,U.S. DOL,OPA,0,0,0,0,0
2013,U.S. DOL,OSEC,0,0,0,0,0
2013,U.S. DOL,OSHA,8,42,20,33,103
2013,U.S. DOL,OWCP,1,0,19,159,179
2013,U.S. DOL,VETS,1,1,1,6,9
2013,U.S. DOL,WB,0,0,0,0,0
2013,U.S. DOL,WHD,1,3,10,8,22
2013,US ADF,US ADF,0,0,0,0,0
2013,US RRB,OIG,0,0,0,0,0
2013,US RRB,RRB,2,0,0,0,2
2013,USAID,USAID,8,8,6,3,25
2013,USCCR,USCCR,0,0,0,0,0
2013,USDA,AMS,2,4,3,2,11
2013,USDA,APHIS,0,4,0,15,19
2013,USDA,ASCR,0,0,0,0,0
2013,USDA,FAS,0,0,1,0,1
2013,USDA,FNCS,25,14,1,2,42
2013,USDA,FS,19,18,16,14,67
2013,USDA,FSA,3,10,3,9,25
2013,USDA,FSIS,4,0,0,2,6
2013,USDA,GIPSA,2,0,0,0,2
2013,USDA,NAD,0,0,0,0,0
2013,USDA,NRCS,0,1,1,0,2
2013,USDA,OBPA,0,0,0,0,0
2013,USDA,OCFO,1,0,0,0,1
2013,USDA,OGC,0,1,0,0,1
2013,USDA,OIG,7,4,4,0,15
2013,USDA,OSEC/OCIO/DM,1,0,0,0,1
2013,USDA,RD,0,0,0,0,0
2013,USDA,REE,0,2,0,1,3
2013,USDA,RMA,0,0,0,0,0
2013,USIBWC,USIBWC,0,0,0,0,0
2013,USITC,USITC,0,0,0,0,0
2013,USNRC,USNRC,5,2,3,5,15
2013,USPS,OIG,23,2,1,9,35
2013,USPS,PS & PIS,26,19,38,13,96
2013,USTDA,USTDA,1,0,0,0,1
2013,USTR,USTR,0,2,0,0,2
2013,VA,Admin,0,0,0,0,0
2013,VA,BVA,0,0,0,0,0
2013,VA,C&LA,0,0,0,0,0
2013,VA,CFM,0,0,0,0,0
2013,VA,GC,49,24,5,165,243
2013,VA,HRM,0,0,0,0,0
2013,VA,IG,0,0,0,0,0
2013,VA,Mgmt,0,0,0,0,0
2013,VA,NCA,0,0,0,0,0
2013,VA,OAL,0,0,0,0,0
2013,VA,OASHRA,0,0,0,0,0
2013,VA,OASP&IA,0,0,0,0,0
2013,VA,ODASB,0,0,0,0,0
2013,VA,ODASIA,0,0,0,0,0
2013,VA,ODI,0,0,0,0,0
2013,VA,OF,0,0,0,0,0
2013,VA,OIT,0,0,0,0,0
2013,VA,ORM,0,0,0,0,0
2013,VA,OSDBU,0,0,0,0,0
2013,VA,OSP,0,0,0,0,0
2013,VA,P&P,0,0,0,0,0
2013,VA,PA,0,0,0,0,0
2013,VA,SEC,0,0,0,0,0
2013,VA,VBA,0,0,0,0,0
2013,VA,VHA,0,0,0,0,0
2014,ABMC,ABMC,0,0,0,0,0
2014,ACUS,ACUS,0,0,0,0,0
2014,AFRH,AFRH,0,0,0,0,0
2014,BBG,BBG,96,1,0,0,97
2014,CEQ,CEQ,0,0,0,0,0
2014,CFPB,CFPB,9,6,2,8,25
2014,CFTC,CFTC,3,2,1,0,6
2014,CIA,CIA,167,55,8,94,324
2014,CIGIE,CIGIE,1,4,1,4,10
2014,CNCS,CNCS,1,0,0,0,1
2014,CO,CO,1,0,0,0,1
2014,CPPBSD,CPPBSD,0,0,0,0,0
2014,CSB,CSB,3,0,0,0,3
2014,CSOSA,CSOSA,0,1,0,0,1
2014,DHS,CBP,112,79,514,286,991
2014,DHS,FEMA,10,0,1,6,17
2014,DHS,FLETC,3,0,0,1,4
2014,DHS,ICE,126,14,103,96,339
2014,DHS,OGC,62,4,16,19,101
2014,DHS,OIG,14,7,0,4,25
2014,DHS,TSA,7,5,9,15,36
2014,DHS,USCG,12,1,9,6,28
2014,DHS,USCIS,524,742,368,285,1919
2014,DHS,USSS,10,1,13,6,30
2014,DNFSB,DNFSB,0,0,0,0,0
2014,DOC,PTO,9,2,3,0,14
2014,DOC,AGC/Admin,28,11,4,12,55
2014,DoD,AF,28,47,16,95,186
2014,DoD,ARMY,55,12,25,22,114
2014,DoD,ASBCA,0,0,0,0,0
2014,DoD,DCAA,2,0,0,0,2
2014,DoD,DCMA,1,1,0,0,2
2014,DoD,DeCA,1,0,0,0,1
2014,DoD,DFAS,0,0,0,0,0
2014,DoD,DHA,6,0,0,2,8
2014,DoD,DIA,27,14,10,17,68
2014,DoD,DISA,5,1,1,3,10
2014,DoD,DLA,1,0,2,5,8
2014,DoD,DoD IG,7,1,6,8,22
2014,DoD,DSS,0,0,0,0,0
2014,DoD,DTRA,0,1,0,0,1
2014,DoD,NAVY,99,30,66,62,257
2014,DoD,NGA,5,2,0,2,9
2014,DoD,NRO,2,1,0,3,6
2014,DoD,NSA,102,2,0,29,133
2014,DoD,OSD/JS,19,20,26,69,134
2014,DOE,BPA,0,0,0,0,0
2014,DOE,CBFO,0,0,0,0,0
2014,DOE,CH,0,0,0,0,0
2014,DOE,EMCBC,0,0,0,0,0
2014,DOE,GFO,0,0,0,0,0
2014,DOE,HQ,40,7,3,27,77
2014,DOE,ID,0,0,0,0,0
2014,DOE,NETL,0,0,0,0,0
2014,DOE,NNSA,0,0,0,0,0
2014,DOE,NR,0,0,0,0,0
2014,DOE,NRLFO,0,0,0,0,0
2014,DOE,ORO,0,0,0,0,0
2014,DOE,OSTI,0,0,0,0,0
2014,DOE,ROO,0,0,0,0,0
2014,DOE,SEPA,0,0,0,0,0
2014,DOE,SPR,0,0,0,0,0
2014,DOE,SRO,0,0,0,0,0
2014,DOE,SWPA,0,0,0,0,0
2014,DOE,WAPA,0,0,0,0,0
2014,DOI,FOIA/PA Appeals,10,4,31,45,90
2014,DOJ,OIP,1908,136,320,729,3093
2014,DOJ,USPC,2,1,0,4,7
2014,DOT,FAA,16,8,36,0,60
2014,DOT,FHWA,2,16,2,7,27
2014,DOT,FMCSA,0,1,1,1,3
2014,DOT,FRA,0,1,0,0,1
2014,DOT,FTA,2,3,1,0,6
2014,DOT,MARAD,1,1,0,0,2
2014,DOT,NHTSA,2,2,1,4,9
2014,DOT,OIG,1,0,0,1,2
2014,DOT,OST,1,4,0,0,5
2014,DOT,PHMSA,1,1,0,1,3
2014,DOT,RITA,0,0,0,2,2
2014,DOT,SLSDC,0,0,0,0,0
2014,ED,OCTAE,0,0,0,0,0
2014,ED,OSHS,0,0,0,0,0
2014,ED,FSA,1,0,1,4,6
2014,ED,IES,0,0,0,0,0
2014,ED,IES-NAGB,0,0,0,0,0
2014,ED,M,0,0,0,1,1
2014,ED,OCFO,0,0,0,0,0
2014,ED,OCFO-CAM,0,0,0,0,0
2014,ED,OCIO,0,0,0,0,0
2014,ED,OCO,0,0,0,0,0
2014,ED,OCR,1,0,0,0,1
2014,ED,OCR-1 Boston,0,0,0,0,0
2014,ED,OCR-2 New York,0,0,1,0,1
2014,ED,OCR-3 Philadelphia,2,0,0,0,2
2014,ED,OCR-4 Atlanta,0,1,0,0,1
2014,ED,OCR-5 Chicago,2,0,0,2,4
2014,ED,OCR-6 Dallas,0,0,0,0,0
2014,ED,OCR-7 Kansas City,0,0,0,0,0
2014,ED,OCR-8 Denver,0,0,0,0,0
2014,ED,OCR-9 San Francisco,0,0,0,0,0
2014,ED,OCR-10 Seattle,0,0,0,1,1
2014,ED,OCR-12 Cleveland,0,0,0,0,0
2014,ED,OCR-Metro D.C.,0,0,0,0,0
2014,ED,ODS,0,0,0,0,0
2014,ED,OESE,0,0,0,0,0
2014,ED,OGC,0,0,0,0,0
2014,ED,OIG,2,5,2,0,9
2014,ED,OII,0,0,0,0,0
2014,ED,OLCA,0,0,0,0,0
2014,ED,OM,0,0,0,0,0
2014,ED,OM-PIRMS,0,0,0,1,1
2014,ED,OPE,0,0,0,0,0
2014,ED,OPEPD,0,0,0,0,0
2014,ED,OS,0,0,0,0,0
2014,ED,OSERS,0,0,0,0,0
2014,ED,OUS,0,0,0,0,0
2014,EEOC,OLC/HDQ,183,57,55,0,295
2014,EPA,HQ,158,1,0,26,185
2014,EPA,Region 1,0,0,0,0,0
2014,EPA,Region 2,0,0,0,0,0
2014,EPA,Region 3,0,0,0,0,0
2014,EPA,Region 4,0,0,0,0,0
2014,EPA,Region 5,0,0,0,0,0
2014,EPA,Region 6,0,0,0,0,0
2014,EPA,Region 7,0,0,0,0,0
2014,EPA,Region 8,0,0,0,0,0
2014,EPA,Region 9,0,0,0,0,0
2014,EPA,Region 10,0,0,0,0,0
2014,Ex-Im Bank,HQ,2,0,0,0,2
2014,FCA,FCA,1,0,0,0,1
2014,FCC,FCC,20,2,0,26,48
2014,FCSIC,FCSIC,0,0,0,0,0
2014,FDIC,FDIC,21,2,0,2,25
2014,FEC,FEC,2,1,0,0,3
2014,FERC,FERC,13,5,0,5,23
2014,FFIEC,FFIEC,0,1,0,0,1
2014,FHFA,FHFA-HQ,6,3,0,1,10
2014,FHFA,FHFA-OIG,3,0,0,1,4
2014,FLRA,FSIP,0,0,0,0,0
2014,FLRA,Authority,0,0,0,0,0
2014,FLRA,IG,0,0,0,0,0
2014,FLRA,OGC,3,0,0,0,3
2014,FLRA,ATRO,0,0,0,0,0
2014,FLRA,BORO,0,0,0,0,0
2014,FLRA,CHRO,0,0,0,0,0
2014,FLRA,DARO,0,0,0,0,0
2014,FLRA,DERO,0,0,0,0,0
2014,FLRA,SFRO,0,0,0,0,0
2014,FLRA,WARO,0,0,0,0,0
2014,FMCS,FMCS,1,0,0,0,1
2014,FMSHRC,FMSHRC,0,0,0,0,0
2014,FOMC,FOMC,0,0,0,0,0
2014,FRB,FRB,15,1,0,0,16
2014,FRTIB,FRTIB,1,1,0,0,2
2014,FTC,FTC,6,3,1,6,16
2014,GSA,GSA,12,2,0,2,16
2014,HHS,CMS,3,4,1,20,28
2014,HHS,OS,83,30,6,99,218
2014,HUD,HQ,13,6,4,6,29
2014,HUD,OIG,8,1,0,0,9
2014,HUD,R01,0,0,0,0,0
2014,HUD,R02,1,0,0,0,1
2014,HUD,R03,1,1,0,0,2
2014,HUD,R04,2,0,3,0,5
2014,HUD,R05,3,2,1,0,6
2014,HUD,R06,2,0,0,1,3
2014,HUD,R07,0,0,0,0,0
2014,HUD,R08,1,0,0,0,1
2014,HUD,R09,1,0,0,0,1
2014,HUD,R0X,1,0,1,0,2
2014,IAF,IAF,0,1,0,0,1
2014,IMLS,IMLS,0,0,0,0,0
2014,LSC,OLA,2,1,0,0,3
2014,LSC,OIG,2,0,0,0,2
2014,MCC,MCC,2,0,0,0,2
2014,MSPB,MSPB,2,2,2,3,9
2014,NARA,NARA,44,12,7,4,67
2014,NASA,AFRC,0,0,0,0,0
2014,NASA,ARC,0,0,0,0,0
2014,NASA,GRC,0,0,0,0,0
2014,NASA,GSFC,0,0,0,0,0
2014,NASA,HQ,0,0,0,0,0
2014,NASA,JPL,0,0,0,0,0
2014,NASA,JSC,0,0,0,0,0
2014,NASA,KSC,0,0,0,0,0
2014,NASA,LaRC,0,0,0,0,0
2014,NASA,MSFC,0,0,0,0,0
2014,NASA,NSSC,0,0,0,0,0
2014,NASA,OGC,7,10,1,3,21
2014,NASA,OIG,1,0,0,0,1
2014,NASA,SSC,0,0,0,0,0
2014,NCPC,NCPC,0,0,0,1,1
2014,NCUA,NCUA,2,0,0,0,2
2014,NEA,NEA,0,0,0,0,0
2014,NEH,NEH,0,0,2,0,2
2014,NIGC,NIGC,1,0,0,0,1
2014,NLRB,NLRB,12,5,2,2,21
2014,NMB,NMB,2,0,0,0,2
2014,NRPC,NRPC,1,0,1,2,4
2014,NSF,OGC,5,5,0,0,10
2014,NSF,OIG,2,2,0,0,4
2014,NTSB,NTSB,1,3,1,7,12
2014,ODNI,ODNI,0,1,1,8,10
2014,OGE,OGE,1,0,0,0,1
2014,OMB,OMB,6,4,1,1,12
2014,ONDCP,ONDCP,0,0,0,0,0
2014,ONHIR,ONHIR,0,0,0,0,0
2014,OPIC,OPIC,1,0,1,2,4
2014,OPM,OPM,9,3,3,6,21
2014,OSC,OSC,2,1,0,3,6
2014,OSHRC,OSHRC,1,0,0,0,1
2014,OSTP,OSTP,3,1,0,0,4
2014,PBGC,PBGC,6,3,0,1,10
2014,PC,FOIA Office,2,1,1,1,5
2014,PC,OIG,0,1,0,0,1
2014,PCLOB,PCLOB,1,0,0,1,2
2014,PRC,PRC,1,0,0,0,1
2014,RATB,RATB,0,0,0,0,0
2014,SBA,SBA,9,9,4,0,22
2014,SEC,SEC,288,21,57,66,432
2014,SIGAR,SIGAR,0,1,0,0,1
2014,SSA,SSA,105,36,114,0,255
2014,SSS,SSS,0,0,2,0,2
2014,State,DoS,236,60,61,25,382
2014,State,OIG,0,0,0,0,0
2014,STB,STB,0,0,0,0,0
2014,Treasury,BEP,6,1,1,0,8
2014,Treasury,DO,9,4,3,0,16
2014,Treasury,FinCEN,5,3,0,0,8
2014,Treasury,IRS,185,0,3,0,188
2014,Treasury,MINT,3,3,0,0,6
2014,Treasury,OCC,4,12,1,5,22
2014,Treasury,TIGTA,14,9,1,2,26
2014,Treasury,TTB,0,0,0,0,0
2014,Treasury,Fiscal Service,12,1,0,0,13
2014,TVA,TVA,3,3,0,0,6
2014,U.S. CPSC,U.S. CPSC,12,2,0,0,14
2014,U.S. DOL,ADJ BDS,0,0,0,1,1
2014,U.S. DOL,ALJ,0,0,0,0,0
2014,U.S. DOL,ASP,0,0,0,0,0
2014,U.S. DOL,BLS,0,0,0,0,0
2014,U.S. DOL,CFO,0,0,0,0,0
2014,U.S. DOL,EBSA,0,0,3,6,9
2014,U.S. DOL,ETA,0,0,9,18,27
2014,U.S. DOL,EXEC SEC,0,0,0,0,0
2014,U.S. DOL,ILAB,0,0,0,0,0
2014,U.S. DOL,MSHA,1,0,4,7,12
2014,U.S. DOL,OASAM,1,0,1,5,7
2014,U.S. DOL,OCIA,0,0,0,0,0
2014,U.S. DOL,ODEP,0,0,0,0,0
2014,U.S. DOL,OFCCP,0,0,0,1,1
2014,U.S. DOL,OIG,0,0,1,1,2
2014,U.S. DOL,OLMS,0,1,1,0,2
2014,U.S. DOL,OPA,0,0,0,0,0
2014,U.S. DOL,OSEC,0,0,0,0,0
2014,U.S. DOL,OSHA,2,3,22,21,48
2014,U.S. DOL,OWCP,4,0,23,120,147
2014,U.S. DOL,SOL,0,1,0,1,2
2014,U.S. DOL,VETS,0,1,0,2,3
2014,U.S. DOL,WB,0,0,0,0,0
2014,U.S. DOL,WHD,1,1,9,5,16
2014,US ADF,US ADF,0,0,0,0,0
2014,US RRB,OIG,0,0,0,0,0
2014,US RRB,RRB,0,0,1,0,1
2014,USAID,USAID,6,10,1,1,18
2014,USCCR,USCCR,1,0,0,0,1
2014,USDA,AMS,1,2,2,3,8
2014,USDA,APHIS,3,3,2,23,31
2014,USDA,ASCR,0,0,0,0,0
2014,USDA,FAS,0,1,0,1,2
2014,USDA,FNCS,4,1,0,1,6
2014,USDA,FS,13,12,11,14,50
2014,USDA,FSA,0,5,5,6,16
2014,USDA,FSIS,7,2,4,3,16
2014,USDA,GIPSA,0,1,0,0,1
2014,USDA,NAD,0,0,0,0,0
2014,USDA,NRCS,0,0,4,5,9
2014,USDA,OBPA,0,0,0,0,0
2014,USDA,OCFO,0,0,0,0,0
2014,USDA,OGC,1,1,0,0,2
2014,USDA,OIG,4,3,1,0,8
2014,USDA,OSEC/OCIO/DM,1,3,1,5,10
2014,USDA,RD,3,2,1,4,10
2014,USDA,REE,0,0,0,0,0
2014,USDA,RMA,0,0,0,0,0
2014,USIBWC,USIBWC,0,0,0,0,0
2014,USITC,USITC,0,3,0,0,3
2014,USNRC,USNRC,15,8,5,14,42
2014,USPS,OIG,30,3,2,3,38
2014,USPS,PS & PIS,53,7,78,14,152
2014,USTDA,USTDA,1,0,0,0,1
2014,USTR,USTR,0,0,0,1,1
2014,VA,Admin,0,0,0,0,0
2014,VA,BVA,0,0,0,0,0
2014,VA,C&LA,0,0,0,0,0
2014,VA,CFM,0,0,0,0,0
2014,VA,GC,69,23,6,139,237
2014,VA,HRM,0,0,0,0,0
2014,VA,IG,10,1,1,3,15
2014,VA,Mgmt,0,0,0,0,0
2014,VA,NCA,0,0,0,0,0
2014,VA,OAL,0,0,0,0,0
2014,VA,OASHRA,0,0,0,0,0
2014,VA,OASP&IA,0,0,0,0,0
2014,VA,ODASB,0,0,0,0,0
2014,VA,ODASIA,0,0,0,0,0
2014,VA,ODI,0,0,0,0,0
2014,VA,OF,0,0,0,0,0
2014,VA,OIT,0,0,0,0,0
2014,VA,ORM,0,0,0,0,0
2014,VA,OSDBU,0,0,0,0,0
2014,VA,OSP,0,0,0,0,0
2014,VA,P&P,0,0,0,0,0
2014,VA,PA,0,0,0,0,0
2014,VA,SEC,0,0,0,0,0
2014,VA,VBA,0,0,0,0,0
2014,VA,VHA,0,0,0,0,0
2015,ABMC,ABMC,0,0,0,0,0
2015,ACUS,ACUS,3,0,0,0,3
2015,AFRH,AFRH,1,0,1,0,2
2015,BBG,BBG,3,0,0,0,3
2015,CEQ,CEQ,0,1,0,0,1
2015,CFPB,CFPB,18,7,4,0,29
2015,CFTC,CFTC,8,1,2,4,15
2015,CIA,CIA,116,46,0,99,261
2015,CIGIE,CIGIE,0,0,0,0,0
2015,CNCS,CNCS,0,0,0,0,0
2015,CO,CO,0,0,0,0,0
2015,CPPBSD,CPPBSD,0,0,0,0,0
2015,CSB,CSB,0,0,0,0,0
2015,CSOSA,CSOSA,0,0,0,0,0
2015,DHS,CBP,383,150,622,492,1647
2015,DHS,FEMA,2,0,8,4,14
2015,DHS,FLETC,0,0,0,0,0
2015,DHS,ICE,279,87,243,0,609
2015,DHS,OGC,32,5,0,63,100
2015,DHS,OIG,24,2,1,9,36
2015,DHS,TSA,11,3,5,10,29
2015,DHS,USCG,12,2,20,7,41
2015,DHS,USCIS,594,767,419,222,2002
2015,DHS,USSS,16,11,12,117,156
2015,DNFSB,DNFSB,0,0,1,0,1
2015,DOC,OIG,3,2,0,1,6
2015,DOC,PTO,21,2,0,3,26
2015,DOC,AGC/Admin,24,5,0,3,32
2015,DoD,AF,49,50,16,125,240
2015,DoD,ARMY,8,0,7,10,25
2015,DoD,ASBCA,0,0,0,0,0
2015,DoD,DCAA,4,0,0,0,4
2015,DoD,DCMA,1,0,0,1,2
2015,DoD,DeCA,0,0,0,0,0
2015,DoD,DFAS,0,1,0,2,3
2015,DoD,DHA,3,0,1,8,12
2015,DoD,DIA,20,18,2,3,43
2015,DoD,DISA,0,0,0,0,0
2015,DoD,DLA,3,3,2,5,13
2015,DoD,DoD IG,10,12,6,7,35
2015,DoD,DSS,3,0,0,0,3
2015,DoD,DTRA,2,0,1,0,3
2015,DoD,NAVY,63,66,48,130,307
2015,DoD,NGA,2,2,0,3,7
2015,DoD,NRO,1,2,0,5,8
2015,DoD,NSA,20,0,0,8,28
2015,DoD,OSD/JS,74,17,96,83,270
2015,DOE,HQ,42,4,4,25,75
2015,DOI,FOIA/PA Appeals,25,16,96,84,221
2015,DOJ,OIP,2467,199,367,1074,4107
2015,DOJ,USPC,2,0,0,0,2
2015,DOT,FAA,39,14,48,0,101
2015,DOT,FHWA,5,6,1,5,17
2015,DOT,FMCSA,0,0,0,0,0
2015,DOT,FRA,1,0,1,0,2
2015,DOT,FTA,2,0,0,1,3
2015,DOT,MARAD,0,2,0,1,3
2015,DOT,NHTSA,7,2,0,2,11
2015,DOT,OIG,0,1,0,4,5
2015,DOT,OST,1,3,1,0,5
2015,DOT,PHMSA,5,1,1,1,8
2015,DOT,RITA,0,0,0,0,0
2015,DOT,SLSDC,0,0,0,0,0
2015,ED,OCTAE,0,0,0,0,0
2015,ED,OM-OCPO,0,0,0,1,1
2015,ED,OSHS,0,0,0,0,0
2015,ED,FSA,4,6,2,0,12
2015,ED,IES,0,0,0,0,0
2015,ED,IES-NAGB,0,0,0,0,0
2015,ED,M,0,0,0,0,0
2015,ED,OCFO,0,0,0,0,0
2015,ED,OCFO-CAM,0,0,0,0,0
2015,ED,OCIO,0,0,0,0,0
2015,ED,OCO,0,0,0,0,0
2015,ED,OCR,0,1,4,0,5
2015,ED,OCR-1 Boston,2,0,0,0,2
2015,ED,OCR-2 New York,2,1,1,0,4
2015,ED,OCR-3 Philadelphia,2,1,1,0,4
2015,ED,OCR-4 Atlanta,3,0,0,0,3
2015,ED,OCR-5 Chicago,5,2,0,0,7
2015,ED,OCR-6 Dallas,6,0,0,0,6
2015,ED,OCR-7 Kansas City,0,0,1,0,1
2015,ED,OCR-8 Denver,0,0,0,0,0
2015,ED,OCR-9 San Francisco,0,2,0,1,3
2015,ED,OCR-10 Seattle,4,0,0,0,4
2015,ED,OCR-12 Cleveland,2,0,1,0,3
2015,ED,OCR-Metro D.C.,2,2,0,1,5
2015,ED,ODS,0,0,0,0,0
2015,ED,OESE,0,0,0,2,2
2015,ED,OGC,0,0,0,0,0
2015,ED,OIG,0,0,0,0,0
2015,ED,OII,0,0,0,0,0
2015,ED,OLCA,0,0,0,0,0
2015,ED,OM,0,0,0,1,1
2015,ED,OPE,0,0,0,0,0
2015,ED,OPEPD,0,0,0,0,0
2015,ED,OS,0,0,0,0,0
2015,ED,OSERS,0,0,0,0,0
2015,ED,OUS,0,0,0,0,0
2015,EEOC,OLC/HDQ,161,51,56,7,275
2015,EPA,HQ,77,27,18,106,228
2015,Ex-Im Bank,OIG,0,0,0,0,0
2015,Ex-Im Bank,HQ,5,0,1,0,6
2015,FCA,FCA,1,0,0,0,1
2015,FCC,FCC,3,0,0,6,9
2015,FCSIC,FCSIC,0,0,0,0,0
2015,FDIC,FDIC,15,2,2,2,21
2015,FEC,FEC,2,1,1,0,4
2015,FERC,FERC,5,3,1,3,12
2015,FFIEC,FFIEC,0,0,0,1,1
2015,FHFA,FHFA-HQ,1,0,0,1,2
2015,FHFA,FHFA-OIG,0,0,3,3,6
2015,FLRA,FSIP,0,0,0,0,0
2015,FLRA,Authority,2,0,0,0,2
2015,FLRA,IG,0,0,0,0,0
2015,FLRA,OGC,1,0,0,1,2
2015,FLRA,ATRO,0,0,0,0,0
2015,FLRA,BORO,0,0,0,0,0
2015,FLRA,CHRO,0,0,0,0,0
2015,FLRA,DARO,0,0,0,0,0
2015,FLRA,DERO,0,0,0,0,0
2015,FLRA,SFRO,0,0,0,0,0
2015,FLRA,WARO,0,0,0,0,0
2015,FMC,FMC,0,0,0,0,0
2015,FMCS,FMCS,0,0,0,0,0
2015,FMSHRC,FMSHRC,0,0,0,0,0
2015,FOMC,FOMC,1,0,0,0,1
2015,FRB,FRB,14,3,0,1,18
2015,FRTIB,FRTIB,1,1,0,0,2
2015,FTC,FTC,23,9,5,0,37
2015,GSA,GSA,22,9,0,6,37
2015,HHS,CMS,0,1,1,90,92
2015,HHS,OS,64,25,4,97,190
2015,HUD,HQ,9,2,2,3,16
2015,HUD,OIG,3,1,0,2,6
2015,HUD,R01,0,0,0,0,0
2015,HUD,R02,0,0,0,0,0
2015,HUD,R03,0,1,0,0,1
2015,HUD,R04,1,1,1,0,3
2015,HUD,R05,1,0,2,0,3
2015,HUD,R06,0,0,1,0,1
2015,HUD,R07,0,0,0,0,0
2015,HUD,R08,0,0,0,1,1
2015,HUD,R09,1,2,0,2,5
2015,HUD,R0X,2,0,0,0,2
2015,IAF,IAF,0,0,0,0,0
2015,IMLS,IMLS,1,0,0,0,1
2015,LSC,OLA,1,0,0,0,1
2015,LSC,OIG,0,0,0,0,0
2015,MCC,MCC,0,0,0,0,0
2015,MSPB,MSPB,3,1,0,1,5
2015,NARA,NARA,2,1,2,22,27
2015,NASA,OGC,13,8,2,4,27
2015,NASA,OIG,0,0,0,0,0
2015,NCPC,NCPC,0,0,0,0,0
2015,NCUA,NCUA,2,2,0,0,4
2015,NEA,NEA,0,0,0,0,0
2015,NEH,NEH,1,0,0,0,1
2015,NIGC,NIGC,2,0,0,0,2
2015,NLRB,NLRB,11,5,3,5,24
2015,NMB,NMB,0,0,0,0,0
2015,NRPC,NRPC,0,0,2,1,3
2015,NSF,OGC,0,2,1,1,4
2015,NSF,OIG,0,0,0,0,0
2015,NTSB,NTSB,0,2,1,4,7
2015,ODNI,ODNI,3,3,0,15,21
2015,OGE,OGE,1,5,0,0,6
2015,OMB,OMB,3,0,0,0,3
2015,ONDCP,ONDCP,0,0,0,0,0
2015,ONHIR,ONHIR,0,0,0,0,0
2015,OPIC,OPIC,0,1,0,0,1
2015,OPM,OPM,4,4,2,10,20
2015,OSC,OSC,3,2,0,2,7
2015,OSHRC,OSHRC,0,0,0,0,0
2015,OSTP,OSTP,5,1,0,0,6
2015,PBGC,PBGC,6,3,3,6,18
2015,PC,FOIA Office,3,1,0,4,8
2015,PC,OIG,1,0,0,0,1
2015,PCLOB,PCLOB,2,1,0,0,3
2015,PRC,PRC,0,0,0,0,0
2015,SBA,SBA,9,2,5,2,18
2015,SEC,SEC,369,29,65,42,505
2015,SIGAR,SIGAR,0,0,0,0,0
2015,SSA,SSA,120,33,119,0,272
2015,SSS,SSS,0,0,0,0,0
2015,State,DoS,92,6,13,7,118
2015,State,OIG,0,0,0,0,0
2015,STB,STB,1,0,1,0,2
2015,Treasury,BEP,2,1,1,0,4
2015,Treasury,DO,4,1,2,2,9
2015,Treasury,FinCEN,14,1,0,1,16
2015,Treasury,IRS,226,0,4,10,240
2015,Treasury,MINT,2,0,0,0,2
2015,Treasury,OCC,3,2,2,11,18
2015,Treasury,TIGTA,16,4,1,0,21
2015,Treasury,TTB,0,0,0,0,0
2015,Treasury,Fiscal Service,16,1,0,0,17
2015,TVA,TVA,7,0,0,0,7
2015,U.S. CPSC,U.S. CPSC,11,4,1,3,19
2015,U.S. DOL,ADJ BDS,0,0,0,0,0
2015,U.S. DOL,ALJ,0,0,0,0,0
2015,U.S. DOL,ASP,0,0,0,0,0
2015,U.S. DOL,BLS,0,0,0,2,2
2015,U.S. DOL,CFO,0,0,0,0,0
2015,U.S. DOL,EBSA,0,0,1,13,14
2015,U.S. DOL,ETA,0,0,9,23,32
2015,U.S. DOL,EXEC SEC,0,0,0,0,0
2015,U.S. DOL,ILAB,0,0,0,0,0
2015,U.S. DOL,MSHA,3,5,3,2,13
2015,U.S. DOL,OASAM,1,1,2,6,10
2015,U.S. DOL,OCIA,0,0,0,0,0
2015,U.S. DOL,ODEP,0,0,0,0,0
2015,U.S. DOL,OFCCP,0,0,0,5,5
2015,U.S. DOL,OIG,0,1,0,0,1
2015,U.S. DOL,OLMS,1,0,1,1,3
2015,U.S. DOL,OPA,0,0,0,0,0
2015,U.S. DOL,OSEC,0,0,0,0,0
2015,U.S. DOL,OSHA,9,1,32,44,86
2015,U.S. DOL,OWCP,0,1,16,62,79
2015,U.S. DOL,SOL,0,0,0,2,2
2015,U.S. DOL,VETS,0,2,0,4,6
2015,U.S. DOL,WB,0,0,0,0,0
2015,U.S. DOL,WHD,0,1,20,23,44
2015,US ADF,US ADF,0,0,0,0,0
2015,US RRB,OIG,0,0,0,0,0
2015,US RRB,RRB,0,0,0,0,0
2015,USAB,USAB,1,0,0,0,1
2015,USAID,USAID,4,9,4,12,29
2015,USCCR,USCCR,0,0,0,0,0
2015,USDA,AMS,0,1,1,1,3
2015,USDA,APHIS,4,2,2,12,20
2015,USDA,ASCR,0,0,0,1,1
2015,USDA,FAS,0,0,1,0,1
2015,USDA,FNCS,3,2,0,1,6
2015,USDA,FS,13,16,7,15,51
2015,USDA,FSA,0,11,1,10,22
2015,USDA,FSIS,3,3,3,3,12
2015,USDA,GIPSA,0,2,1,0,3
2015,USDA,NAD,0,0,0,0,0
2015,USDA,NRCS,1,0,4,3,8
2015,USDA,OBPA,0,0,0,0,0
2015,USDA,OCFO,0,0,0,0,0
2015,USDA,OGC,0,0,0,0,0
2015,USDA,OIG,3,3,0,0,6
2015,USDA,OSEC/OCIO/DM,2,2,0,0,4
2015,USDA,RD,2,5,1,21,29
2015,USDA,REE,0,0,0,2,2
2015,USDA,RMA,0,1,1,1,3
2015,USIBWC,USIBWC,0,1,0,0,1
2015,USITC,USITC,2,2,0,0,4
2015,USNRC,USNRC,23,13,5,29,70
2015,USPS,OIG,17,3,2,2,24
2015,USPS,PS & PIS,78,48,52,26,204
2015,USTDA,USTDA,0,0,0,0,0
2015,USTR,USTR,2,3,0,0,5
2015,VA,Admin,0,0,0,0,0
2015,VA,BVA,0,0,0,0,0
2015,VA,C&LA,0,0,0,0,0
2015,VA,CFM,0,0,0,0,0
2015,VA,GC,78,13,8,233,332
2015,VA,HRM,0,0,0,0,0
2015,VA,IG,28,3,2,12,45
2015,VA,Mgmt,0,0,0,0,0
2015,VA,NCA,0,0,0,0,0
2015,VA,OAL,0,0,0,0,0
2015,VA,OASHRA,0,0,0,0,0
2015,VA,OASP&IA,0,0,0,0,0
2015,VA,ODASB,0,0,0,0,0
2015,VA,ODASIA,0,0,0,0,0
2015,VA,ODI,0,0,0,0,0
2015,VA,OIT,0,0,0,0,0
2015,VA,ORM,0,0,0,0,0
2015,VA,OSDBU,0,0,0,0,0
2015,VA,OSP,0,0,0,0,0
2015,VA,P&P,0,0,0,0,0
2015,VA,PA,0,0,0,0,0
2015,VA,SEC,0,0,0,0,0
2015,VA,VBA,0,0,0,0,0
2015,VA,VHA,0,0,0,0,0
