Component,Number Affirmed on Appeal,Number Partially Affirmed & Partially Reserved/Remanded on Appeal,Number Completely Reserved/Remanded on Appeal,Number of Appeals Closed for Other Reasons,Total,
BEP,0,0,0,0,0,
BPD,0,0,0,0,0,
CFPB,6,1,1,0,8,
DO,9,6,4,3,22,
FinCEN,11,1,0,1,13,
FMS,5,2,0,0,7,
IRS,178,0,0,0,178,
MINT,2,1,0,0,3,
OCC,11,25,10,8,54,
TIGTA,17,6,1,1,25,
TTB,0,1,0,0,1,
Total,239,43,16,13,311,
