Component,Number Affirmed on Appeal,Number Partially Affirmed & Partially Reserved/Remanded on Appeal,Number Completely Reserved/Remanded on Appeal,Number of Appeals Closed for Other Reasons,Total,
FAA,39,14,48,0,101,
FHWA,5,6,1,5,17,
FMCSA,0,0,0,0,0,
FRA,1,0,1,0,2,
FTA,2,0,0,1,3,
MARAD,0,2,0,1,3,
NHTSA,7,2,0,2,11,
OIG,0,1,0,4,5,
OST,1,3,1,0,5,
PHMSA,5,1,1,1,8,
RITA,0,0,0,0,0,
SLSDC,0,0,0,0,0,
Total,60,29,52,14,155,
